CensusTract,SchoolYear,GradeLevel,Count,PreviousGrade,PreviousYear,PreviousThreeYear,PreviousFiveYear,OneYearPercentGrowth,OneYearGrowth,ThreeYearPercentGrowth,ThreeYearGrowth,FiveYearPercentGrowth,FiveYearGrowth,LongTract,Zip
18,2001,2,1,0,1,1,1,0,0,0,0,0,0,36047001800,11220
18,2002,3,1,0,0,1,1,1,1,0,0,0,0,36047001800,11220
18,2003,0,1,1,0,1,1,1,1,0,0,0,0,36047001800,11220
18,2003,3,1,0,1,1,1,0,0,0,0,0,0,36047001800,11220
18,2003,4,1,1,0,1,1,1,1,0,0,0,0,36047001800,11220
18,2004,1,1,0,0,0,0,1,1,1,1,1,1,36047001800,11220
18,2004,5,1,0,0,0,0,1,1,1,1,1,1,36047001800,11220
18,2005,2,1,0,0,0,0,1,1,1,1,1,1,36047001800,11220
18,2005,4,1,0,0,0,0,1,1,1,1,1,1,36047001800,11220
18,2006,3,1,0,1,1,1,0,0,0,0,0,0,36047001800,11220
18,2007,4,1,0,0,0,0,1,1,1,1,1,1,36047001800,11220
18,2008,5,1,0,0,0,0,1,1,1,1,1,1,36047001800,11220
20,2001,0,4,4,4,4,4,0,0,0,0,0,0,36047002000,11220
20,2001,1,6,4,6,6,6,0,0,0,0,0,0,36047002000,11220
20,2001,2,1,6,1,1,1,0,0,0,0,0,0,36047002000,11220
20,2001,3,5,1,5,5,5,0,0,0,0,0,0,36047002000,11220
20,2001,4,8,5,8,8,8,0,0,0,0,0,0,36047002000,11220
20,2001,5,7,8,7,7,7,0,0,0,0,0,0,36047002000,11220
20,2002,0,7,7,4,7,7,0.75,3,0,0,0,0,36047002000,11220
20,2002,1,3,7,6,3,3,-0.5,-3,0,0,0,0,36047002000,11220
20,2002,2,5,3,1,5,5,4,4,0,0,0,0,36047002000,11220
20,2002,3,2,5,5,2,2,-0.6,-3,0,0,0,0,36047002000,11220
20,2002,4,3,2,8,3,3,-0.625,-5,0,0,0,0,36047002000,11220
20,2002,5,6,3,7,6,6,-0.142857,-1,0,0,0,0,36047002000,11220
20,2003,0,5,5,7,5,5,-0.285714,-2,0,0,0,0,36047002000,11220
20,2003,1,7,5,3,7,7,1.333333,4,0,0,0,0,36047002000,11220
20,2003,2,4,7,5,4,4,-0.2,-1,0,0,0,0,36047002000,11220
20,2003,3,8,4,2,8,8,3,6,0,0,0,0,36047002000,11220
20,2003,4,3,8,3,3,3,0,0,0,0,0,0,36047002000,11220
20,2003,5,2,3,6,2,2,-0.666667,-4,0,0,0,0,36047002000,11220
20,2004,0,3,3,5,4,4,-0.4,-2,-0.25,-1,-0.25,-1,36047002000,11220
20,2004,1,8,3,7,6,6,0.142857,1,0.333333,2,0.333333,2,36047002000,11220
20,2004,2,5,8,4,1,1,0.25,1,4,4,4,4,36047002000,11220
20,2004,3,5,5,8,5,5,-0.375,-3,0,0,0,0,36047002000,11220
20,2004,4,7,5,3,8,8,1.333333,4,-0.125,-1,-0.125,-1,36047002000,11220
20,2004,5,2,7,2,7,7,0,0,-0.714286,-5,-0.714286,-5,36047002000,11220
20,2005,0,7,7,3,7,7,1.333333,4,0,0,0,0,36047002000,11220
20,2005,1,6,7,8,3,3,-0.25,-2,1,3,1,3,36047002000,11220
20,2005,2,10,6,5,5,5,1,5,1,5,1,5,36047002000,11220
20,2005,3,5,10,5,2,2,0,0,1.5,3,1.5,3,36047002000,11220
20,2005,4,5,5,7,3,3,-0.285714,-2,0.666667,2,0.666667,2,36047002000,11220
20,2005,5,8,5,2,6,6,3,6,0.333333,2,0.333333,2,36047002000,11220
20,2006,0,4,4,7,5,5,-0.428571,-3,-0.2,-1,-0.2,-1,36047002000,11220
20,2006,1,7,4,6,7,7,0.166667,1,0,0,0,0,36047002000,11220
20,2006,2,6,7,10,4,4,-0.4,-4,0.5,2,0.5,2,36047002000,11220
20,2006,3,9,6,5,8,8,0.8,4,0.125,1,0.125,1,36047002000,11220
20,2006,4,4,9,5,3,3,-0.2,-1,0.333333,1,0.333333,1,36047002000,11220
20,2006,5,6,4,8,2,2,-0.25,-2,2,4,2,4,36047002000,11220
20,2007,0,8,8,4,3,3,1,4,1.666667,5,1.666667,5,36047002000,11220
20,2007,1,5,8,7,8,8,-0.285714,-2,-0.375,-3,-0.375,-3,36047002000,11220
20,2007,2,8,5,6,5,5,0.333333,2,0.6,3,0.6,3,36047002000,11220
20,2007,3,6,8,9,5,5,-0.333333,-3,0.2,1,0.2,1,36047002000,11220
20,2007,4,11,6,4,7,7,1.75,7,0.571429,4,0.571429,4,36047002000,11220
20,2007,5,6,11,6,2,2,0,0,2,4,2,4,36047002000,11220
20,2008,0,6,6,8,7,7,-0.25,-2,-0.142857,-1,-0.142857,-1,36047002000,11220
20,2008,1,10,6,5,6,6,1,5,0.666667,4,0.666667,4,36047002000,11220
20,2008,2,6,10,8,10,10,-0.25,-2,-0.4,-4,-0.4,-4,36047002000,11220
20,2008,3,9,6,6,5,5,0.5,3,0.8,4,0.8,4,36047002000,11220
20,2008,4,7,9,11,5,5,-0.363636,-4,0.4,2,0.4,2,36047002000,11220
20,2008,5,11,7,6,8,8,0.833333,5,0.375,3,0.375,3,36047002000,11220
20,2009,0,6,6,6,4,4,0,0,0.5,2,0.5,2,36047002000,11220
20,2009,1,6,6,10,7,7,-0.4,-4,-0.142857,-1,-0.142857,-1,36047002000,11220
20,2009,2,8,6,6,6,6,0.333333,2,0.333333,2,0.333333,2,36047002000,11220
20,2009,3,5,8,9,9,9,-0.444444,-4,-0.444444,-4,-0.444444,-4,36047002000,11220
20,2009,4,9,5,7,4,4,0.285714,2,1.25,5,1.25,5,36047002000,11220
20,2009,5,7,9,11,6,6,-0.363636,-4,0.166667,1,0.166667,1,36047002000,11220
20,2010,0,4,4,6,8,8,-0.333333,-2,-0.5,-4,-0.5,-4,36047002000,11220
20,2010,1,5,4,6,5,5,-0.166667,-1,0,0,0,0,36047002000,11220
20,2010,2,6,5,8,8,8,-0.25,-2,-0.25,-2,-0.25,-2,36047002000,11220
20,2010,3,10,6,5,6,6,1,5,0.666667,4,0.666667,4,36047002000,11220
20,2010,4,5,10,9,11,11,-0.444444,-4,-0.545455,-6,-0.545455,-6,36047002000,11220
20,2010,5,5,5,7,6,6,-0.285714,-2,-0.166667,-1,-0.166667,-1,36047002000,11220
22,2001,0,49,49,49,49,49,0,0,0,0,0,0,36047002200,11220
22,2001,1,50,49,50,50,50,0,0,0,0,0,0,36047002200,11220
22,2001,2,61,50,61,61,61,0,0,0,0,0,0,36047002200,11220
22,2001,3,50,61,50,50,50,0,0,0,0,0,0,36047002200,11220
22,2001,4,47,50,47,47,47,0,0,0,0,0,0,36047002200,11220
22,2001,5,45,47,45,45,45,0,0,0,0,0,0,36047002200,11220
22,2002,0,52,52,49,52,52,0.061224,3,0,0,0,0,36047002200,11220
22,2002,1,52,52,50,52,52,0.04,2,0,0,0,0,36047002200,11220
22,2002,2,55,52,61,55,55,-0.098361,-6,0,0,0,0,36047002200,11220
22,2002,3,54,55,50,54,54,0.08,4,0,0,0,0,36047002200,11220
22,2002,4,51,54,47,51,51,0.085106,4,0,0,0,0,36047002200,11220
22,2002,5,48,51,45,48,48,0.066667,3,0,0,0,0,36047002200,11220
22,2003,0,38,38,52,38,38,-0.269231,-14,0,0,0,0,36047002200,11220
22,2003,1,56,38,52,56,56,0.076923,4,0,0,0,0,36047002200,11220
22,2003,2,52,56,55,52,52,-0.054545,-3,0,0,0,0,36047002200,11220
22,2003,3,53,52,54,53,53,-0.018519,-1,0,0,0,0,36047002200,11220
22,2003,4,54,53,51,54,54,0.058824,3,0,0,0,0,36047002200,11220
22,2003,5,48,54,48,48,48,0,0,0,0,0,0,36047002200,11220
22,2004,0,40,40,38,49,49,0.052632,2,-0.183673,-9,-0.183673,-9,36047002200,11220
22,2004,1,43,40,56,50,50,-0.232143,-13,-0.14,-7,-0.14,-7,36047002200,11220
22,2004,2,53,43,52,61,61,0.019231,1,-0.131148,-8,-0.131148,-8,36047002200,11220
22,2004,3,49,53,53,50,50,-0.075472,-4,-0.02,-1,-0.02,-1,36047002200,11220
22,2004,4,52,49,54,47,47,-0.037037,-2,0.106383,5,0.106383,5,36047002200,11220
22,2004,5,52,52,48,45,45,0.083333,4,0.155556,7,0.155556,7,36047002200,11220
22,2005,0,48,48,40,52,52,0.2,8,-0.076923,-4,-0.076923,-4,36047002200,11220
22,2005,1,54,48,43,52,52,0.255814,11,0.038462,2,0.038462,2,36047002200,11220
22,2005,2,44,54,53,55,55,-0.169811,-9,-0.2,-11,-0.2,-11,36047002200,11220
22,2005,3,48,44,49,54,54,-0.020408,-1,-0.111111,-6,-0.111111,-6,36047002200,11220
22,2005,4,40,48,52,51,51,-0.230769,-12,-0.215686,-11,-0.215686,-11,36047002200,11220
22,2005,5,49,40,52,48,48,-0.057692,-3,0.020833,1,0.020833,1,36047002200,11220
22,2006,0,43,43,48,38,38,-0.104167,-5,0.131579,5,0.131579,5,36047002200,11220
22,2006,1,48,43,54,56,56,-0.111111,-6,-0.142857,-8,-0.142857,-8,36047002200,11220
22,2006,2,51,48,44,52,52,0.159091,7,-0.019231,-1,-0.019231,-1,36047002200,11220
22,2006,3,39,51,48,53,53,-0.1875,-9,-0.264151,-14,-0.264151,-14,36047002200,11220
22,2006,4,47,39,40,54,54,0.175,7,-0.12963,-7,-0.12963,-7,36047002200,11220
22,2006,5,36,47,49,48,48,-0.265306,-13,-0.25,-12,-0.25,-12,36047002200,11220
22,2007,0,31,31,43,40,40,-0.27907,-12,-0.225,-9,-0.225,-9,36047002200,11220
22,2007,1,42,31,48,43,43,-0.125,-6,-0.023256,-1,-0.023256,-1,36047002200,11220
22,2007,2,46,42,51,53,53,-0.098039,-5,-0.132075,-7,-0.132075,-7,36047002200,11220
22,2007,3,49,46,39,49,49,0.25641,10,0,0,0,0,36047002200,11220
22,2007,4,36,49,47,52,52,-0.234043,-11,-0.307692,-16,-0.307692,-16,36047002200,11220
22,2007,5,40,36,36,52,52,0.111111,4,-0.230769,-12,-0.230769,-12,36047002200,11220
22,2008,0,38,38,31,48,48,0.225806,7,-0.208333,-10,-0.208333,-10,36047002200,11220
22,2008,1,40,38,42,54,54,-0.047619,-2,-0.259259,-14,-0.259259,-14,36047002200,11220
22,2008,2,42,40,46,44,44,-0.086957,-4,-0.045455,-2,-0.045455,-2,36047002200,11220
22,2008,3,40,42,49,48,48,-0.183673,-9,-0.166667,-8,-0.166667,-8,36047002200,11220
22,2008,4,50,40,36,40,40,0.388889,14,0.25,10,0.25,10,36047002200,11220
22,2008,5,33,50,40,49,49,-0.175,-7,-0.326531,-16,-0.326531,-16,36047002200,11220
22,2009,0,53,53,38,43,43,0.394737,15,0.232558,10,0.232558,10,36047002200,11220
22,2009,1,42,53,40,48,48,0.05,2,-0.125,-6,-0.125,-6,36047002200,11220
22,2009,2,42,42,42,51,51,0,0,-0.176471,-9,-0.176471,-9,36047002200,11220
22,2009,3,41,42,40,39,39,0.025,1,0.051282,2,0.051282,2,36047002200,11220
22,2009,4,42,41,50,47,47,-0.16,-8,-0.106383,-5,-0.106383,-5,36047002200,11220
22,2009,5,52,42,33,36,36,0.575758,19,0.444444,16,0.444444,16,36047002200,11220
22,2010,0,49,49,53,31,31,-0.075472,-4,0.580645,18,0.580645,18,36047002200,11220
22,2010,1,54,49,42,42,42,0.285714,12,0.285714,12,0.285714,12,36047002200,11220
22,2010,2,43,54,42,46,46,0.02381,1,-0.065217,-3,-0.065217,-3,36047002200,11220
22,2010,3,47,43,41,49,49,0.146341,6,-0.040816,-2,-0.040816,-2,36047002200,11220
22,2010,4,44,47,42,36,36,0.047619,2,0.222222,8,0.222222,8,36047002200,11220
22,2010,5,43,44,52,40,40,-0.173077,-9,0.075,3,0.075,3,36047002200,11220
30,2001,0,16,16,16,16,16,0,0,0,0,0,0,36047003000,11220
30,2001,1,11,16,11,11,11,0,0,0,0,0,0,36047003000,11220
30,2001,2,15,11,15,15,15,0,0,0,0,0,0,36047003000,11220
30,2001,3,21,15,21,21,21,0,0,0,0,0,0,36047003000,11220
30,2001,4,17,21,17,17,17,0,0,0,0,0,0,36047003000,11220
30,2001,5,16,17,16,16,16,0,0,0,0,0,0,36047003000,11220
30,2002,0,13,13,16,13,13,-0.1875,-3,0,0,0,0,36047003000,11220
30,2002,1,16,13,11,16,16,0.454545,5,0,0,0,0,36047003000,11220
30,2002,2,12,16,15,12,12,-0.2,-3,0,0,0,0,36047003000,11220
30,2002,3,15,12,21,15,15,-0.285714,-6,0,0,0,0,36047003000,11220
30,2002,4,18,15,17,18,18,0.058824,1,0,0,0,0,36047003000,11220
30,2002,5,14,18,16,14,14,-0.125,-2,0,0,0,0,36047003000,11220
30,2003,0,12,12,13,12,12,-0.076923,-1,0,0,0,0,36047003000,11220
30,2003,1,12,12,16,12,12,-0.25,-4,0,0,0,0,36047003000,11220
30,2003,2,17,12,12,17,17,0.416667,5,0,0,0,0,36047003000,11220
30,2003,3,12,17,15,12,12,-0.2,-3,0,0,0,0,36047003000,11220
30,2003,4,14,12,18,14,14,-0.222222,-4,0,0,0,0,36047003000,11220
30,2003,5,16,14,14,16,16,0.142857,2,0,0,0,0,36047003000,11220
30,2004,0,17,17,12,16,16,0.416667,5,0.0625,1,0.0625,1,36047003000,11220
30,2004,1,15,17,12,11,11,0.25,3,0.363636,4,0.363636,4,36047003000,11220
30,2004,2,13,15,17,15,15,-0.235294,-4,-0.133333,-2,-0.133333,-2,36047003000,11220
30,2004,3,19,13,12,21,21,0.583333,7,-0.095238,-2,-0.095238,-2,36047003000,11220
30,2004,4,10,19,14,17,17,-0.285714,-4,-0.411765,-7,-0.411765,-7,36047003000,11220
30,2004,5,12,10,16,16,16,-0.25,-4,-0.25,-4,-0.25,-4,36047003000,11220
30,2005,0,9,9,17,13,13,-0.470588,-8,-0.307692,-4,-0.307692,-4,36047003000,11220
30,2005,1,16,9,15,16,16,0.066667,1,0,0,0,0,36047003000,11220
30,2005,2,16,16,13,12,12,0.230769,3,0.333333,4,0.333333,4,36047003000,11220
30,2005,3,10,16,19,15,15,-0.473684,-9,-0.333333,-5,-0.333333,-5,36047003000,11220
30,2005,4,17,10,10,18,18,0.7,7,-0.055556,-1,-0.055556,-1,36047003000,11220
30,2005,5,10,17,12,14,14,-0.166667,-2,-0.285714,-4,-0.285714,-4,36047003000,11220
30,2006,0,16,16,9,12,12,0.777778,7,0.333333,4,0.333333,4,36047003000,11220
30,2006,1,4,16,16,12,12,-0.75,-12,-0.666667,-8,-0.666667,-8,36047003000,11220
30,2006,2,18,4,16,17,17,0.125,2,0.058824,1,0.058824,1,36047003000,11220
30,2006,3,13,18,10,12,12,0.3,3,0.083333,1,0.083333,1,36047003000,11220
30,2006,4,13,13,17,14,14,-0.235294,-4,-0.071429,-1,-0.071429,-1,36047003000,11220
30,2006,5,16,13,10,16,16,0.6,6,0,0,0,0,36047003000,11220
30,2007,0,15,15,16,17,17,-0.0625,-1,-0.117647,-2,-0.117647,-2,36047003000,11220
30,2007,1,17,15,4,15,15,3.25,13,0.133333,2,0.133333,2,36047003000,11220
30,2007,2,4,17,18,13,13,-0.777778,-14,-0.692308,-9,-0.692308,-9,36047003000,11220
30,2007,3,19,4,13,19,19,0.461538,6,0,0,0,0,36047003000,11220
30,2007,4,12,19,13,10,10,-0.076923,-1,0.2,2,0.2,2,36047003000,11220
30,2007,5,11,12,16,12,12,-0.3125,-5,-0.083333,-1,-0.083333,-1,36047003000,11220
30,2008,0,10,10,15,9,9,-0.333333,-5,0.111111,1,0.111111,1,36047003000,11220
30,2008,1,17,10,17,16,16,0,0,0.0625,1,0.0625,1,36047003000,11220
30,2008,2,17,17,4,16,16,3.25,13,0.0625,1,0.0625,1,36047003000,11220
30,2008,3,7,17,19,10,10,-0.631579,-12,-0.3,-3,-0.3,-3,36047003000,11220
30,2008,4,20,7,12,17,17,0.666667,8,0.176471,3,0.176471,3,36047003000,11220
30,2008,5,14,20,11,10,10,0.272727,3,0.4,4,0.4,4,36047003000,11220
30,2009,0,11,11,10,16,16,0.1,1,-0.3125,-5,-0.3125,-5,36047003000,11220
30,2009,1,11,11,17,4,4,-0.352941,-6,1.75,7,1.75,7,36047003000,11220
30,2009,2,17,11,17,18,18,0,0,-0.055556,-1,-0.055556,-1,36047003000,11220
30,2009,3,16,17,7,13,13,1.285714,9,0.230769,3,0.230769,3,36047003000,11220
30,2009,4,7,16,20,13,13,-0.65,-13,-0.461538,-6,-0.461538,-6,36047003000,11220
30,2009,5,23,7,14,16,16,0.642857,9,0.4375,7,0.4375,7,36047003000,11220
30,2010,0,16,16,11,15,15,0.454545,5,0.066667,1,0.066667,1,36047003000,11220
30,2010,1,11,16,11,17,17,0,0,-0.352941,-6,-0.352941,-6,36047003000,11220
30,2010,2,13,11,17,4,4,-0.235294,-4,2.25,9,2.25,9,36047003000,11220
30,2010,3,16,13,16,19,19,0,0,-0.157895,-3,-0.157895,-3,36047003000,11220
30,2010,4,16,16,7,12,12,1.285714,9,0.333333,4,0.333333,4,36047003000,11220
30,2010,5,7,16,23,11,11,-0.695652,-16,-0.363636,-4,-0.363636,-4,36047003000,11220
34,2001,0,13,13,13,13,13,0,0,0,0,0,0,36047003400,11209
34,2001,1,17,13,17,17,17,0,0,0,0,0,0,36047003400,11209
34,2001,2,17,17,17,17,17,0,0,0,0,0,0,36047003400,11209
34,2001,3,23,17,23,23,23,0,0,0,0,0,0,36047003400,11209
34,2001,4,9,23,9,9,9,0,0,0,0,0,0,36047003400,11209
34,2001,5,7,9,7,7,7,0,0,0,0,0,0,36047003400,11209
34,2002,0,17,17,13,17,17,0.307692,4,0,0,0,0,36047003400,11209
34,2002,1,11,17,17,11,11,-0.352941,-6,0,0,0,0,36047003400,11209
34,2002,2,14,11,17,14,14,-0.176471,-3,0,0,0,0,36047003400,11209
34,2002,3,18,14,23,18,18,-0.217391,-5,0,0,0,0,36047003400,11209
34,2002,4,19,18,9,19,19,1.111111,10,0,0,0,0,36047003400,11209
34,2002,5,9,19,7,9,9,0.285714,2,0,0,0,0,36047003400,11209
34,2003,0,18,18,17,18,18,0.058824,1,0,0,0,0,36047003400,11209
34,2003,1,19,18,11,19,19,0.727273,8,0,0,0,0,36047003400,11209
34,2003,2,15,19,14,15,15,0.071429,1,0,0,0,0,36047003400,11209
34,2003,3,17,15,18,17,17,-0.055556,-1,0,0,0,0,36047003400,11209
34,2003,4,17,17,19,17,17,-0.105263,-2,0,0,0,0,36047003400,11209
34,2003,5,21,17,9,21,21,1.333333,12,0,0,0,0,36047003400,11209
34,2004,0,20,20,18,13,13,0.111111,2,0.538462,7,0.538462,7,36047003400,11209
34,2004,1,19,20,19,17,17,0,0,0.117647,2,0.117647,2,36047003400,11209
34,2004,2,20,19,15,17,17,0.333333,5,0.176471,3,0.176471,3,36047003400,11209
34,2004,3,15,20,17,23,23,-0.117647,-2,-0.347826,-8,-0.347826,-8,36047003400,11209
34,2004,4,18,15,17,9,9,0.058824,1,1,9,1,9,36047003400,11209
34,2004,5,18,18,21,7,7,-0.142857,-3,1.571429,11,1.571429,11,36047003400,11209
34,2005,0,18,18,20,17,17,-0.1,-2,0.058824,1,0.058824,1,36047003400,11209
34,2005,1,25,18,19,11,11,0.315789,6,1.272727,14,1.272727,14,36047003400,11209
34,2005,2,21,25,20,14,14,0.05,1,0.5,7,0.5,7,36047003400,11209
34,2005,3,18,21,15,18,18,0.2,3,0,0,0,0,36047003400,11209
34,2005,4,14,18,18,19,19,-0.222222,-4,-0.263158,-5,-0.263158,-5,36047003400,11209
34,2005,5,19,14,18,9,9,0.055556,1,1.111111,10,1.111111,10,36047003400,11209
34,2006,0,24,24,18,18,18,0.333333,6,0.333333,6,0.333333,6,36047003400,11209
34,2006,1,23,24,25,19,19,-0.08,-2,0.210526,4,0.210526,4,36047003400,11209
34,2006,2,21,23,21,15,15,0,0,0.4,6,0.4,6,36047003400,11209
34,2006,3,21,21,18,17,17,0.166667,3,0.235294,4,0.235294,4,36047003400,11209
34,2006,4,14,21,14,17,17,0,0,-0.176471,-3,-0.176471,-3,36047003400,11209
34,2006,5,12,14,19,21,21,-0.368421,-7,-0.428571,-9,-0.428571,-9,36047003400,11209
34,2007,0,27,27,24,20,20,0.125,3,0.35,7,0.35,7,36047003400,11209
34,2007,1,27,27,23,19,19,0.173913,4,0.421053,8,0.421053,8,36047003400,11209
34,2007,2,24,27,21,20,20,0.142857,3,0.2,4,0.2,4,36047003400,11209
34,2007,3,20,24,21,15,15,-0.047619,-1,0.333333,5,0.333333,5,36047003400,11209
34,2007,4,22,20,14,18,18,0.571429,8,0.222222,4,0.222222,4,36047003400,11209
34,2007,5,12,22,12,18,18,0,0,-0.333333,-6,-0.333333,-6,36047003400,11209
34,2008,0,16,16,27,18,18,-0.407407,-11,-0.111111,-2,-0.111111,-2,36047003400,11209
34,2008,1,25,16,27,25,25,-0.074074,-2,0,0,0,0,36047003400,11209
34,2008,2,27,25,24,21,21,0.125,3,0.285714,6,0.285714,6,36047003400,11209
34,2008,3,26,27,20,18,18,0.3,6,0.444444,8,0.444444,8,36047003400,11209
34,2008,4,22,26,22,14,14,0,0,0.571429,8,0.571429,8,36047003400,11209
34,2008,5,23,22,12,19,19,0.916667,11,0.210526,4,0.210526,4,36047003400,11209
34,2009,0,25,25,16,24,24,0.5625,9,0.041667,1,0.041667,1,36047003400,11209
34,2009,1,19,25,25,23,23,-0.24,-6,-0.173913,-4,-0.173913,-4,36047003400,11209
34,2009,2,27,19,27,21,21,0,0,0.285714,6,0.285714,6,36047003400,11209
34,2009,3,29,27,26,21,21,0.115385,3,0.380952,8,0.380952,8,36047003400,11209
34,2009,4,27,29,22,14,14,0.227273,5,0.928571,13,0.928571,13,36047003400,11209
34,2009,5,20,27,23,12,12,-0.130435,-3,0.666667,8,0.666667,8,36047003400,11209
34,2010,0,27,27,25,27,27,0.08,2,0,0,0,0,36047003400,11209
34,2010,1,25,27,19,27,27,0.315789,6,-0.074074,-2,-0.074074,-2,36047003400,11209
34,2010,2,20,25,27,24,24,-0.259259,-7,-0.166667,-4,-0.166667,-4,36047003400,11209
34,2010,3,27,20,29,20,20,-0.068966,-2,0.35,7,0.35,7,36047003400,11209
34,2010,4,27,27,27,22,22,0,0,0.227273,5,0.227273,5,36047003400,11209
34,2010,5,26,27,20,12,12,0.3,6,1.166667,14,1.166667,14,36047003400,11209
36,2001,0,19,19,19,19,19,0,0,0,0,0,0,36047003600,11209
36,2001,1,35,19,35,35,35,0,0,0,0,0,0,36047003600,11209
36,2001,2,36,35,36,36,36,0,0,0,0,0,0,36047003600,11209
36,2001,3,30,36,30,30,30,0,0,0,0,0,0,36047003600,11209
36,2001,4,19,30,19,19,19,0,0,0,0,0,0,36047003600,11209
36,2001,5,29,19,29,29,29,0,0,0,0,0,0,36047003600,11209
36,2002,0,21,21,19,21,21,0.105263,2,0,0,0,0,36047003600,11209
36,2002,1,22,21,35,22,22,-0.371429,-13,0,0,0,0,36047003600,11209
36,2002,2,38,22,36,38,38,0.055556,2,0,0,0,0,36047003600,11209
36,2002,3,38,38,30,38,38,0.266667,8,0,0,0,0,36047003600,11209
36,2002,4,29,38,19,29,29,0.526316,10,0,0,0,0,36047003600,11209
36,2002,5,17,29,29,17,17,-0.413793,-12,0,0,0,0,36047003600,11209
36,2003,0,26,26,21,26,26,0.238095,5,0,0,0,0,36047003600,11209
36,2003,1,26,26,22,26,26,0.181818,4,0,0,0,0,36047003600,11209
36,2003,2,24,26,38,24,24,-0.368421,-14,0,0,0,0,36047003600,11209
36,2003,3,42,24,38,42,42,0.105263,4,0,0,0,0,36047003600,11209
36,2003,4,33,42,29,33,33,0.137931,4,0,0,0,0,36047003600,11209
36,2003,5,25,33,17,25,25,0.470588,8,0,0,0,0,36047003600,11209
36,2004,0,22,22,26,19,19,-0.153846,-4,0.157895,3,0.157895,3,36047003600,11209
36,2004,1,21,22,26,35,35,-0.192308,-5,-0.4,-14,-0.4,-14,36047003600,11209
36,2004,2,23,21,24,36,36,-0.041667,-1,-0.361111,-13,-0.361111,-13,36047003600,11209
36,2004,3,27,23,42,30,30,-0.357143,-15,-0.1,-3,-0.1,-3,36047003600,11209
36,2004,4,42,27,33,19,19,0.272727,9,1.210526,23,1.210526,23,36047003600,11209
36,2004,5,31,42,25,29,29,0.24,6,0.068966,2,0.068966,2,36047003600,11209
36,2005,0,13,13,22,21,21,-0.409091,-9,-0.380952,-8,-0.380952,-8,36047003600,11209
36,2005,1,23,13,21,22,22,0.095238,2,0.045455,1,0.045455,1,36047003600,11209
36,2005,2,19,23,23,38,38,-0.173913,-4,-0.5,-19,-0.5,-19,36047003600,11209
36,2005,3,24,19,27,38,38,-0.111111,-3,-0.368421,-14,-0.368421,-14,36047003600,11209
36,2005,4,25,24,42,29,29,-0.404762,-17,-0.137931,-4,-0.137931,-4,36047003600,11209
36,2005,5,40,25,31,17,17,0.290323,9,1.352941,23,1.352941,23,36047003600,11209
36,2006,0,24,24,13,26,26,0.846154,11,-0.076923,-2,-0.076923,-2,36047003600,11209
36,2006,1,20,24,23,26,26,-0.130435,-3,-0.230769,-6,-0.230769,-6,36047003600,11209
36,2006,2,22,20,19,24,24,0.157895,3,-0.083333,-2,-0.083333,-2,36047003600,11209
36,2006,3,21,22,24,42,42,-0.125,-3,-0.5,-21,-0.5,-21,36047003600,11209
36,2006,4,27,21,25,33,33,0.08,2,-0.181818,-6,-0.181818,-6,36047003600,11209
36,2006,5,25,27,40,25,25,-0.375,-15,0,0,0,0,36047003600,11209
36,2007,0,21,21,24,22,22,-0.125,-3,-0.045455,-1,-0.045455,-1,36047003600,11209
36,2007,1,26,21,20,21,21,0.3,6,0.238095,5,0.238095,5,36047003600,11209
36,2007,2,18,26,22,23,23,-0.181818,-4,-0.217391,-5,-0.217391,-5,36047003600,11209
36,2007,3,20,18,21,27,27,-0.047619,-1,-0.259259,-7,-0.259259,-7,36047003600,11209
36,2007,4,21,20,27,42,42,-0.222222,-6,-0.5,-21,-0.5,-21,36047003600,11209
36,2007,5,23,21,25,31,31,-0.08,-2,-0.258065,-8,-0.258065,-8,36047003600,11209
36,2008,0,15,15,21,13,13,-0.285714,-6,0.153846,2,0.153846,2,36047003600,11209
36,2008,1,24,15,26,23,23,-0.076923,-2,0.043478,1,0.043478,1,36047003600,11209
36,2008,2,21,24,18,19,19,0.166667,3,0.105263,2,0.105263,2,36047003600,11209
36,2008,3,13,21,20,24,24,-0.35,-7,-0.458333,-11,-0.458333,-11,36047003600,11209
36,2008,4,19,13,21,25,25,-0.095238,-2,-0.24,-6,-0.24,-6,36047003600,11209
36,2008,5,22,19,23,40,40,-0.043478,-1,-0.45,-18,-0.45,-18,36047003600,11209
36,2009,0,30,30,15,24,24,1,15,0.25,6,0.25,6,36047003600,11209
36,2009,1,19,30,24,20,20,-0.208333,-5,-0.05,-1,-0.05,-1,36047003600,11209
36,2009,2,21,19,21,22,22,0,0,-0.045455,-1,-0.045455,-1,36047003600,11209
36,2009,3,21,21,13,21,21,0.615385,8,0,0,0,0,36047003600,11209
36,2009,4,12,21,19,27,27,-0.368421,-7,-0.555556,-15,-0.555556,-15,36047003600,11209
36,2009,5,20,12,22,25,25,-0.090909,-2,-0.2,-5,-0.2,-5,36047003600,11209
36,2010,0,30,30,30,21,21,0,0,0.428571,9,0.428571,9,36047003600,11209
36,2010,1,28,30,19,26,26,0.473684,9,0.076923,2,0.076923,2,36047003600,11209
36,2010,2,22,28,21,18,18,0.047619,1,0.222222,4,0.222222,4,36047003600,11209
36,2010,3,23,22,21,20,20,0.095238,2,0.15,3,0.15,3,36047003600,11209
36,2010,4,21,23,12,21,21,0.75,9,0,0,0,0,36047003600,11209
36,2010,5,10,21,20,23,23,-0.5,-10,-0.565217,-13,-0.565217,-13,36047003600,11209
38,2001,0,9,9,9,9,9,0,0,0,0,0,0,36047003800,11209
38,2001,1,6,9,6,6,6,0,0,0,0,0,0,36047003800,11209
38,2001,2,7,6,7,7,7,0,0,0,0,0,0,36047003800,11209
38,2001,3,6,7,6,6,6,0,0,0,0,0,0,36047003800,11209
38,2001,4,9,6,9,9,9,0,0,0,0,0,0,36047003800,11209
38,2001,5,6,9,6,6,6,0,0,0,0,0,0,36047003800,11209
38,2002,0,6,6,9,6,6,-0.333333,-3,0,0,0,0,36047003800,11209
38,2002,1,9,6,6,9,9,0.5,3,0,0,0,0,36047003800,11209
38,2002,2,7,9,7,7,7,0,0,0,0,0,0,36047003800,11209
38,2002,3,7,7,6,7,7,0.166667,1,0,0,0,0,36047003800,11209
38,2002,4,6,7,9,6,6,-0.333333,-3,0,0,0,0,36047003800,11209
38,2002,5,10,6,6,10,10,0.666667,4,0,0,0,0,36047003800,11209
38,2003,0,4,4,6,4,4,-0.333333,-2,0,0,0,0,36047003800,11209
38,2003,1,7,4,9,7,7,-0.222222,-2,0,0,0,0,36047003800,11209
38,2003,2,8,7,7,8,8,0.142857,1,0,0,0,0,36047003800,11209
38,2003,3,6,8,7,6,6,-0.142857,-1,0,0,0,0,36047003800,11209
38,2003,4,7,6,6,7,7,0.166667,1,0,0,0,0,36047003800,11209
38,2003,5,5,7,10,5,5,-0.5,-5,0,0,0,0,36047003800,11209
38,2004,0,6,6,4,9,9,0.5,2,-0.333333,-3,-0.333333,-3,36047003800,11209
38,2004,1,2,6,7,6,6,-0.714286,-5,-0.666667,-4,-0.666667,-4,36047003800,11209
38,2004,2,6,2,8,7,7,-0.25,-2,-0.142857,-1,-0.142857,-1,36047003800,11209
38,2004,3,7,6,6,6,6,0.166667,1,0.166667,1,0.166667,1,36047003800,11209
38,2004,4,7,7,7,9,9,0,0,-0.222222,-2,-0.222222,-2,36047003800,11209
38,2004,5,5,7,5,6,6,0,0,-0.166667,-1,-0.166667,-1,36047003800,11209
38,2005,0,5,5,6,6,6,-0.166667,-1,-0.166667,-1,-0.166667,-1,36047003800,11209
38,2005,1,5,5,2,9,9,1.5,3,-0.444444,-4,-0.444444,-4,36047003800,11209
38,2005,2,1,5,6,7,7,-0.833333,-5,-0.857143,-6,-0.857143,-6,36047003800,11209
38,2005,3,6,1,7,7,7,-0.142857,-1,-0.142857,-1,-0.142857,-1,36047003800,11209
38,2005,4,9,6,7,6,6,0.285714,2,0.5,3,0.5,3,36047003800,11209
38,2005,5,6,9,5,10,10,0.2,1,-0.4,-4,-0.4,-4,36047003800,11209
38,2006,0,5,5,5,4,4,0,0,0.25,1,0.25,1,36047003800,11209
38,2006,1,6,5,5,7,7,0.2,1,-0.142857,-1,-0.142857,-1,36047003800,11209
38,2006,2,4,6,1,8,8,3,3,-0.5,-4,-0.5,-4,36047003800,11209
38,2006,3,2,4,6,6,6,-0.666667,-4,-0.666667,-4,-0.666667,-4,36047003800,11209
38,2006,4,6,2,9,7,7,-0.333333,-3,-0.142857,-1,-0.142857,-1,36047003800,11209
38,2006,5,9,6,6,5,5,0.5,3,0.8,4,0.8,4,36047003800,11209
38,2007,0,7,7,5,6,6,0.4,2,0.166667,1,0.166667,1,36047003800,11209
38,2007,1,6,7,6,2,2,0,0,2,4,2,4,36047003800,11209
38,2007,2,4,6,4,6,6,0,0,-0.333333,-2,-0.333333,-2,36047003800,11209
38,2007,3,4,4,2,7,7,1,2,-0.428571,-3,-0.428571,-3,36047003800,11209
38,2007,4,2,4,6,7,7,-0.666667,-4,-0.714286,-5,-0.714286,-5,36047003800,11209
38,2007,5,10,2,9,5,5,0.111111,1,1,5,1,5,36047003800,11209
38,2008,0,9,9,7,5,5,0.285714,2,0.8,4,0.8,4,36047003800,11209
38,2008,1,7,9,6,5,5,0.166667,1,0.4,2,0.4,2,36047003800,11209
38,2008,2,8,7,4,1,1,1,4,7,7,7,7,36047003800,11209
38,2008,3,6,8,4,6,6,0.5,2,0,0,0,0,36047003800,11209
38,2008,4,4,6,2,9,9,1,2,-0.555556,-5,-0.555556,-5,36047003800,11209
38,2008,5,2,4,10,6,6,-0.8,-8,-0.666667,-4,-0.666667,-4,36047003800,11209
38,2009,0,6,6,9,5,5,-0.333333,-3,0.2,1,0.2,1,36047003800,11209
38,2009,1,9,6,7,6,6,0.285714,2,0.5,3,0.5,3,36047003800,11209
38,2009,2,7,9,8,4,4,-0.125,-1,0.75,3,0.75,3,36047003800,11209
38,2009,3,7,7,6,2,2,0.166667,1,2.5,5,2.5,5,36047003800,11209
38,2009,4,4,7,4,6,6,0,0,-0.333333,-2,-0.333333,-2,36047003800,11209
38,2009,5,7,4,2,9,9,2.5,5,-0.222222,-2,-0.222222,-2,36047003800,11209
38,2010,0,9,9,6,7,7,0.5,3,0.285714,2,0.285714,2,36047003800,11209
38,2010,1,6,9,9,6,6,-0.333333,-3,0,0,0,0,36047003800,11209
38,2010,2,9,6,7,4,4,0.285714,2,1.25,5,1.25,5,36047003800,11209
38,2010,3,7,9,7,4,4,0,0,0.75,3,0.75,3,36047003800,11209
38,2010,4,8,7,4,2,2,1,4,3,6,3,6,36047003800,11209
38,2010,5,5,8,7,10,10,-0.285714,-2,-0.5,-5,-0.5,-5,36047003800,11209
44,2001,0,9,9,9,9,9,0,0,0,0,0,0,,
44,2001,1,10,9,10,10,10,0,0,0,0,0,0,,
44,2001,2,9,10,9,9,9,0,0,0,0,0,0,,
44,2001,3,12,9,12,12,12,0,0,0,0,0,0,,
44,2001,4,13,12,13,13,13,0,0,0,0,0,0,,
44,2001,5,12,13,12,12,12,0,0,0,0,0,0,,
44,2002,0,15,15,9,15,15,0.666667,6,0,0,0,0,,
44,2002,1,13,15,10,13,13,0.3,3,0,0,0,0,,
44,2002,2,11,13,9,11,11,0.222222,2,0,0,0,0,,
44,2002,3,8,11,12,8,8,-0.333333,-4,0,0,0,0,,
44,2002,4,12,8,13,12,12,-0.076923,-1,0,0,0,0,,
44,2002,5,13,12,12,13,13,0.083333,1,0,0,0,0,,
44,2003,0,7,7,15,7,7,-0.533333,-8,0,0,0,0,,
44,2003,1,18,7,13,18,18,0.384615,5,0,0,0,0,,
44,2003,2,14,18,11,14,14,0.272727,3,0,0,0,0,,
44,2003,3,10,14,8,10,10,0.25,2,0,0,0,0,,
44,2003,4,11,10,12,11,11,-0.083333,-1,0,0,0,0,,
44,2003,5,10,11,13,10,10,-0.230769,-3,0,0,0,0,,
44,2004,0,9,9,7,9,9,0.285714,2,0,0,0,0,,
44,2004,1,7,9,18,10,10,-0.611111,-11,-0.3,-3,-0.3,-3,,
44,2004,2,16,7,14,9,9,0.142857,2,0.777778,7,0.777778,7,,
44,2004,3,12,16,10,12,12,0.2,2,0,0,0,0,,
44,2004,4,10,12,11,13,13,-0.090909,-1,-0.230769,-3,-0.230769,-3,,
44,2004,5,11,10,10,12,12,0.1,1,-0.083333,-1,-0.083333,-1,,
44,2005,0,5,5,9,15,15,-0.444444,-4,-0.666667,-10,-0.666667,-10,,
44,2005,1,10,5,7,13,13,0.428571,3,-0.230769,-3,-0.230769,-3,,
44,2005,2,7,10,16,11,11,-0.5625,-9,-0.363636,-4,-0.363636,-4,,
44,2005,3,12,7,12,8,8,0,0,0.5,4,0.5,4,,
44,2005,4,15,12,10,12,12,0.5,5,0.25,3,0.25,3,,
44,2005,5,9,15,11,13,13,-0.181818,-2,-0.307692,-4,-0.307692,-4,,
44,2006,0,11,11,5,7,7,1.2,6,0.571429,4,0.571429,4,,
44,2006,1,4,11,10,18,18,-0.6,-6,-0.777778,-14,-0.777778,-14,,
44,2006,2,9,4,7,14,14,0.285714,2,-0.357143,-5,-0.357143,-5,,
44,2006,3,7,9,12,10,10,-0.416667,-5,-0.3,-3,-0.3,-3,,
44,2006,4,12,7,15,11,11,-0.2,-3,0.090909,1,0.090909,1,,
44,2006,5,11,12,9,10,10,0.222222,2,0.1,1,0.1,1,,
44,2007,0,13,13,11,9,9,0.181818,2,0.444444,4,0.444444,4,,
44,2007,1,8,13,4,7,7,1,4,0.142857,1,0.142857,1,,
44,2007,2,4,8,9,16,16,-0.555556,-5,-0.75,-12,-0.75,-12,,
44,2007,3,7,4,7,12,12,0,0,-0.416667,-5,-0.416667,-5,,
44,2007,4,6,7,12,10,10,-0.5,-6,-0.4,-4,-0.4,-4,,
44,2007,5,11,6,11,11,11,0,0,0,0,0,0,,
44,2008,0,15,15,13,5,5,0.153846,2,2,10,2,10,,
44,2008,1,15,15,8,10,10,0.875,7,0.5,5,0.5,5,,
44,2008,2,8,15,4,7,7,1,4,0.142857,1,0.142857,1,,
44,2008,3,6,8,7,12,12,-0.142857,-1,-0.5,-6,-0.5,-6,,
44,2008,4,7,6,6,15,15,0.166667,1,-0.533333,-8,-0.533333,-8,,
44,2008,5,7,7,11,9,9,-0.363636,-4,-0.222222,-2,-0.222222,-2,,
44,2009,0,19,19,15,11,11,0.266667,4,0.727273,8,0.727273,8,,
44,2009,1,14,19,15,4,4,-0.066667,-1,2.5,10,2.5,10,,
44,2009,2,13,14,8,9,9,0.625,5,0.444444,4,0.444444,4,,
44,2009,3,8,13,6,7,7,0.333333,2,0.142857,1,0.142857,1,,
44,2009,4,10,8,7,12,12,0.428571,3,-0.166667,-2,-0.166667,-2,,
44,2009,5,8,10,7,11,11,0.142857,1,-0.272727,-3,-0.272727,-3,,
44,2010,0,16,16,19,13,13,-0.157895,-3,0.230769,3,0.230769,3,,
44,2010,1,23,16,14,8,8,0.642857,9,1.875,15,1.875,15,,
44,2010,2,14,23,13,4,4,0.076923,1,2.5,10,2.5,10,,
44,2010,3,13,14,8,7,7,0.625,5,0.857143,6,0.857143,6,,
44,2010,4,7,13,10,6,6,-0.3,-3,0.166667,1,0.166667,1,,
44,2010,5,11,7,8,11,11,0.375,3,0,0,0,0,,
46,2001,0,7,7,7,7,7,0,0,0,0,0,0,36047004600,11209
46,2001,1,6,7,6,6,6,0,0,0,0,0,0,36047004600,11209
46,2001,2,3,6,3,3,3,0,0,0,0,0,0,36047004600,11209
46,2001,3,6,3,6,6,6,0,0,0,0,0,0,36047004600,11209
46,2001,4,3,6,3,3,3,0,0,0,0,0,0,36047004600,11209
46,2001,5,8,3,8,8,8,0,0,0,0,0,0,36047004600,11209
46,2002,0,3,3,7,3,3,-0.571429,-4,0,0,0,0,36047004600,11209
46,2002,1,5,3,6,5,5,-0.166667,-1,0,0,0,0,36047004600,11209
46,2002,2,5,5,3,5,5,0.666667,2,0,0,0,0,36047004600,11209
46,2002,3,2,5,6,2,2,-0.666667,-4,0,0,0,0,36047004600,11209
46,2002,4,3,2,3,3,3,0,0,0,0,0,0,36047004600,11209
46,2002,5,4,3,8,4,4,-0.5,-4,0,0,0,0,36047004600,11209
46,2003,0,4,4,3,4,4,0.333333,1,0,0,0,0,36047004600,11209
46,2003,1,3,4,5,3,3,-0.4,-2,0,0,0,0,36047004600,11209
46,2003,2,6,3,5,6,6,0.2,1,0,0,0,0,36047004600,11209
46,2003,3,3,6,2,3,3,0.5,1,0,0,0,0,36047004600,11209
46,2003,4,3,3,3,3,3,0,0,0,0,0,0,36047004600,11209
46,2003,5,3,3,4,3,3,-0.25,-1,0,0,0,0,36047004600,11209
46,2004,0,5,5,4,7,7,0.25,1,-0.285714,-2,-0.285714,-2,36047004600,11209
46,2004,1,4,5,3,6,6,0.333333,1,-0.333333,-2,-0.333333,-2,36047004600,11209
46,2004,2,3,4,6,3,3,-0.5,-3,0,0,0,0,36047004600,11209
46,2004,3,6,3,3,6,6,1,3,0,0,0,0,36047004600,11209
46,2004,4,3,6,3,3,3,0,0,0,0,0,0,36047004600,11209
46,2004,5,2,3,3,8,8,-0.333333,-1,-0.75,-6,-0.75,-6,36047004600,11209
46,2005,0,2,2,5,3,3,-0.6,-3,-0.333333,-1,-0.333333,-1,36047004600,11209
46,2005,1,3,2,4,5,5,-0.25,-1,-0.4,-2,-0.4,-2,36047004600,11209
46,2005,2,4,3,3,5,5,0.333333,1,-0.2,-1,-0.2,-1,36047004600,11209
46,2005,3,3,4,6,2,2,-0.5,-3,0.5,1,0.5,1,36047004600,11209
46,2005,4,7,3,3,3,3,1.333333,4,1.333333,4,1.333333,4,36047004600,11209
46,2005,5,2,7,2,4,4,0,0,-0.5,-2,-0.5,-2,36047004600,11209
46,2006,0,9,9,2,4,4,3.5,7,1.25,5,1.25,5,36047004600,11209
46,2006,1,4,9,3,3,3,0.333333,1,0.333333,1,0.333333,1,36047004600,11209
46,2006,2,5,4,4,6,6,0.25,1,-0.166667,-1,-0.166667,-1,36047004600,11209
46,2006,3,6,5,3,3,3,1,3,1,3,1,3,36047004600,11209
46,2006,4,2,6,7,3,3,-0.714286,-5,-0.333333,-1,-0.333333,-1,36047004600,11209
46,2006,5,8,2,2,3,3,3,6,1.666667,5,1.666667,5,36047004600,11209
46,2007,0,13,13,9,5,5,0.444444,4,1.6,8,1.6,8,36047004600,11209
46,2007,1,10,13,4,4,4,1.5,6,1.5,6,1.5,6,36047004600,11209
46,2007,2,2,10,5,3,3,-0.6,-3,-0.333333,-1,-0.333333,-1,36047004600,11209
46,2007,3,4,2,6,6,6,-0.333333,-2,-0.333333,-2,-0.333333,-2,36047004600,11209
46,2007,4,5,4,2,3,3,1.5,3,0.666667,2,0.666667,2,36047004600,11209
46,2007,5,2,5,8,2,2,-0.75,-6,0,0,0,0,36047004600,11209
46,2008,0,9,9,13,2,2,-0.307692,-4,3.5,7,3.5,7,36047004600,11209
46,2008,1,12,9,10,3,3,0.2,2,3,9,3,9,36047004600,11209
46,2008,2,9,12,2,4,4,3.5,7,1.25,5,1.25,5,36047004600,11209
46,2008,3,3,9,4,3,3,-0.25,-1,0,0,0,0,36047004600,11209
46,2008,4,4,3,5,7,7,-0.2,-1,-0.428571,-3,-0.428571,-3,36047004600,11209
46,2008,5,5,4,2,2,2,1.5,3,1.5,3,1.5,3,36047004600,11209
46,2009,0,9,9,9,9,9,0,0,0,0,0,0,36047004600,11209
46,2009,1,9,9,12,4,4,-0.25,-3,1.25,5,1.25,5,36047004600,11209
46,2009,2,16,9,9,5,5,0.777778,7,2.2,11,2.2,11,36047004600,11209
46,2009,3,10,16,3,6,6,2.333333,7,0.666667,4,0.666667,4,36047004600,11209
46,2009,4,8,10,4,2,2,1,4,3,6,3,6,36047004600,11209
46,2009,5,6,8,5,8,8,0.2,1,-0.25,-2,-0.25,-2,36047004600,11209
46,2010,0,6,6,9,13,13,-0.333333,-3,-0.538462,-7,-0.538462,-7,36047004600,11209
46,2010,1,11,6,9,10,10,0.222222,2,0.1,1,0.1,1,36047004600,11209
46,2010,2,9,11,16,2,2,-0.4375,-7,3.5,7,3.5,7,36047004600,11209
46,2010,3,17,9,10,4,4,0.7,7,3.25,13,3.25,13,36047004600,11209
46,2010,4,9,17,8,5,5,0.125,1,0.8,4,0.8,4,36047004600,11209
46,2010,5,9,9,6,2,2,0.5,3,3.5,7,3.5,7,36047004600,11209
50,2001,0,11,11,11,11,11,0,0,0,0,0,0,36047005000,11209
50,2001,1,10,11,10,10,10,0,0,0,0,0,0,36047005000,11209
50,2001,2,17,10,17,17,17,0,0,0,0,0,0,36047005000,11209
50,2001,3,7,17,7,7,7,0,0,0,0,0,0,36047005000,11209
50,2001,4,6,7,6,6,6,0,0,0,0,0,0,36047005000,11209
50,2001,5,7,6,7,7,7,0,0,0,0,0,0,36047005000,11209
50,2002,0,6,6,11,6,6,-0.454545,-5,0,0,0,0,36047005000,11209
50,2002,1,11,6,10,11,11,0.1,1,0,0,0,0,36047005000,11209
50,2002,2,11,11,17,11,11,-0.352941,-6,0,0,0,0,36047005000,11209
50,2002,3,16,11,7,16,16,1.285714,9,0,0,0,0,36047005000,11209
50,2002,4,4,16,6,4,4,-0.333333,-2,0,0,0,0,36047005000,11209
50,2002,5,6,4,7,6,6,-0.142857,-1,0,0,0,0,36047005000,11209
50,2003,0,9,9,6,9,9,0.5,3,0,0,0,0,36047005000,11209
50,2003,1,4,9,11,4,4,-0.636364,-7,0,0,0,0,36047005000,11209
50,2003,2,9,4,11,9,9,-0.181818,-2,0,0,0,0,36047005000,11209
50,2003,3,10,9,16,10,10,-0.375,-6,0,0,0,0,36047005000,11209
50,2003,4,17,10,4,17,17,3.25,13,0,0,0,0,36047005000,11209
50,2003,5,5,17,6,5,5,-0.166667,-1,0,0,0,0,36047005000,11209
50,2004,0,7,7,9,11,11,-0.222222,-2,-0.363636,-4,-0.363636,-4,36047005000,11209
50,2004,1,8,7,4,10,10,1,4,-0.2,-2,-0.2,-2,36047005000,11209
50,2004,2,4,8,9,17,17,-0.555556,-5,-0.764706,-13,-0.764706,-13,36047005000,11209
50,2004,3,10,4,10,7,7,0,0,0.428571,3,0.428571,3,36047005000,11209
50,2004,4,9,10,17,6,6,-0.470588,-8,0.5,3,0.5,3,36047005000,11209
50,2004,5,16,9,5,7,7,2.2,11,1.285714,9,1.285714,9,36047005000,11209
50,2005,0,8,8,7,6,6,0.142857,1,0.333333,2,0.333333,2,36047005000,11209
50,2005,1,10,8,8,11,11,0.25,2,-0.090909,-1,-0.090909,-1,36047005000,11209
50,2005,2,8,10,4,11,11,1,4,-0.272727,-3,-0.272727,-3,36047005000,11209
50,2005,3,7,8,10,16,16,-0.3,-3,-0.5625,-9,-0.5625,-9,36047005000,11209
50,2005,4,11,7,9,4,4,0.222222,2,1.75,7,1.75,7,36047005000,11209
50,2005,5,9,11,16,6,6,-0.4375,-7,0.5,3,0.5,3,36047005000,11209
50,2006,0,17,17,8,9,9,1.125,9,0.888889,8,0.888889,8,36047005000,11209
50,2006,1,9,17,10,4,4,-0.1,-1,1.25,5,1.25,5,36047005000,11209
50,2006,2,6,9,8,9,9,-0.25,-2,-0.333333,-3,-0.333333,-3,36047005000,11209
50,2006,3,8,6,7,10,10,0.142857,1,-0.2,-2,-0.2,-2,36047005000,11209
50,2006,4,6,8,11,17,17,-0.454545,-5,-0.647059,-11,-0.647059,-11,36047005000,11209
50,2006,5,11,6,9,5,5,0.222222,2,1.2,6,1.2,6,36047005000,11209
50,2007,0,11,11,17,7,7,-0.352941,-6,0.571429,4,0.571429,4,36047005000,11209
50,2007,1,15,11,9,8,8,0.666667,6,0.875,7,0.875,7,36047005000,11209
50,2007,2,9,15,6,4,4,0.5,3,1.25,5,1.25,5,36047005000,11209
50,2007,3,4,9,8,10,10,-0.5,-4,-0.6,-6,-0.6,-6,36047005000,11209
50,2007,4,7,4,6,9,9,0.166667,1,-0.222222,-2,-0.222222,-2,36047005000,11209
50,2007,5,4,7,11,16,16,-0.636364,-7,-0.75,-12,-0.75,-12,36047005000,11209
50,2008,0,15,15,11,8,8,0.363636,4,0.875,7,0.875,7,36047005000,11209
50,2008,1,10,15,15,10,10,-0.333333,-5,0,0,0,0,36047005000,11209
50,2008,2,17,10,9,8,8,0.888889,8,1.125,9,1.125,9,36047005000,11209
50,2008,3,9,17,4,7,7,1.25,5,0.285714,2,0.285714,2,36047005000,11209
50,2008,4,4,9,7,11,11,-0.428571,-3,-0.636364,-7,-0.636364,-7,36047005000,11209
50,2008,5,7,4,4,9,9,0.75,3,-0.222222,-2,-0.222222,-2,36047005000,11209
50,2009,0,20,20,15,17,17,0.333333,5,0.176471,3,0.176471,3,36047005000,11209
50,2009,1,17,20,10,9,9,0.7,7,0.888889,8,0.888889,8,36047005000,11209
50,2009,2,13,17,17,6,6,-0.235294,-4,1.166667,7,1.166667,7,36047005000,11209
50,2009,3,19,13,9,8,8,1.111111,10,1.375,11,1.375,11,36047005000,11209
50,2009,4,15,19,4,6,6,2.75,11,1.5,9,1.5,9,36047005000,11209
50,2009,5,13,15,7,11,11,0.857143,6,0.181818,2,0.181818,2,36047005000,11209
50,2010,0,12,12,20,11,11,-0.4,-8,0.090909,1,0.090909,1,36047005000,11209
50,2010,1,24,12,17,15,15,0.411765,7,0.6,9,0.6,9,36047005000,11209
50,2010,2,19,24,13,9,9,0.461538,6,1.111111,10,1.111111,10,36047005000,11209
50,2010,3,12,19,19,4,4,-0.368421,-7,2,8,2,8,36047005000,11209
50,2010,4,20,12,15,7,7,0.333333,5,1.857143,13,1.857143,13,36047005000,11209
50,2010,5,13,20,13,4,4,0,0,2.25,9,2.25,9,36047005000,11209
51,2001,5,1,0,1,1,1,0,0,0,0,0,0,36047005100,11231
54,2001,0,10,10,10,10,10,0,0,0,0,0,0,36047005400,11209
54,2001,1,14,10,14,14,14,0,0,0,0,0,0,36047005400,11209
54,2001,2,16,14,16,16,16,0,0,0,0,0,0,36047005400,11209
54,2001,3,9,16,9,9,9,0,0,0,0,0,0,36047005400,11209
54,2001,4,13,9,13,13,13,0,0,0,0,0,0,36047005400,11209
54,2001,5,6,13,6,6,6,0,0,0,0,0,0,36047005400,11209
54,2002,0,10,10,10,10,10,0,0,0,0,0,0,36047005400,11209
54,2002,1,11,10,14,11,11,-0.214286,-3,0,0,0,0,36047005400,11209
54,2002,2,11,11,16,11,11,-0.3125,-5,0,0,0,0,36047005400,11209
54,2002,3,10,11,9,10,10,0.111111,1,0,0,0,0,36047005400,11209
54,2002,4,8,10,13,8,8,-0.384615,-5,0,0,0,0,36047005400,11209
54,2002,5,9,8,6,9,9,0.5,3,0,0,0,0,36047005400,11209
54,2003,0,12,12,10,12,12,0.2,2,0,0,0,0,36047005400,11209
54,2003,1,14,12,11,14,14,0.272727,3,0,0,0,0,36047005400,11209
54,2003,2,13,14,11,13,13,0.181818,2,0,0,0,0,36047005400,11209
54,2003,3,12,13,10,12,12,0.2,2,0,0,0,0,36047005400,11209
54,2003,4,15,12,8,15,15,0.875,7,0,0,0,0,36047005400,11209
54,2003,5,7,15,9,7,7,-0.222222,-2,0,0,0,0,36047005400,11209
54,2004,0,11,11,12,10,10,-0.083333,-1,0.1,1,0.1,1,36047005400,11209
54,2004,1,7,11,14,14,14,-0.5,-7,-0.5,-7,-0.5,-7,36047005400,11209
54,2004,2,14,7,13,16,16,0.076923,1,-0.125,-2,-0.125,-2,36047005400,11209
54,2004,3,9,14,12,9,9,-0.25,-3,0,0,0,0,36047005400,11209
54,2004,4,8,9,15,13,13,-0.466667,-7,-0.384615,-5,-0.384615,-5,36047005400,11209
54,2004,5,14,8,7,6,6,1,7,1.333333,8,1.333333,8,36047005400,11209
54,2005,0,8,8,11,10,10,-0.272727,-3,-0.2,-2,-0.2,-2,36047005400,11209
54,2005,1,10,8,7,11,11,0.428571,3,-0.090909,-1,-0.090909,-1,36047005400,11209
54,2005,2,3,10,14,11,11,-0.785714,-11,-0.727273,-8,-0.727273,-8,36047005400,11209
54,2005,3,13,3,9,10,10,0.444444,4,0.3,3,0.3,3,36047005400,11209
54,2005,4,6,13,8,8,8,-0.25,-2,-0.25,-2,-0.25,-2,36047005400,11209
54,2005,5,6,6,14,9,9,-0.571429,-8,-0.333333,-3,-0.333333,-3,36047005400,11209
54,2006,0,6,6,8,12,12,-0.25,-2,-0.5,-6,-0.5,-6,36047005400,11209
54,2006,1,8,6,10,14,14,-0.2,-2,-0.428571,-6,-0.428571,-6,36047005400,11209
54,2006,2,10,8,3,13,13,2.333333,7,-0.230769,-3,-0.230769,-3,36047005400,11209
54,2006,3,3,10,13,12,12,-0.769231,-10,-0.75,-9,-0.75,-9,36047005400,11209
54,2006,4,11,3,6,15,15,0.833333,5,-0.266667,-4,-0.266667,-4,36047005400,11209
54,2006,5,3,11,6,7,7,-0.5,-3,-0.571429,-4,-0.571429,-4,36047005400,11209
54,2007,0,16,16,6,11,11,1.666667,10,0.454545,5,0.454545,5,36047005400,11209
54,2007,1,6,16,8,7,7,-0.25,-2,-0.142857,-1,-0.142857,-1,36047005400,11209
54,2007,2,6,6,10,14,14,-0.4,-4,-0.571429,-8,-0.571429,-8,36047005400,11209
54,2007,3,11,6,3,9,9,2.666667,8,0.222222,2,0.222222,2,36047005400,11209
54,2007,4,2,11,11,8,8,-0.818182,-9,-0.75,-6,-0.75,-6,36047005400,11209
54,2007,5,7,2,3,14,14,1.333333,4,-0.5,-7,-0.5,-7,36047005400,11209
54,2008,0,23,23,16,8,8,0.4375,7,1.875,15,1.875,15,36047005400,11209
54,2008,1,11,23,6,10,10,0.833333,5,0.1,1,0.1,1,36047005400,11209
54,2008,2,2,11,6,3,3,-0.666667,-4,-0.333333,-1,-0.333333,-1,36047005400,11209
54,2008,3,7,2,11,13,13,-0.363636,-4,-0.461538,-6,-0.461538,-6,36047005400,11209
54,2008,4,7,7,2,6,6,2.5,5,0.166667,1,0.166667,1,36047005400,11209
54,2008,5,2,7,7,6,6,-0.714286,-5,-0.666667,-4,-0.666667,-4,36047005400,11209
54,2009,0,11,11,23,6,6,-0.521739,-12,0.833333,5,0.833333,5,36047005400,11209
54,2009,1,27,11,11,8,8,1.454545,16,2.375,19,2.375,19,36047005400,11209
54,2009,2,14,27,2,10,10,6,12,0.4,4,0.4,4,36047005400,11209
54,2009,3,4,14,7,3,3,-0.428571,-3,0.333333,1,0.333333,1,36047005400,11209
54,2009,4,5,4,7,11,11,-0.285714,-2,-0.545455,-6,-0.545455,-6,36047005400,11209
54,2009,5,6,5,2,3,3,2,4,1,3,1,3,36047005400,11209
54,2010,0,16,16,11,16,16,0.454545,5,0,0,0,0,36047005400,11209
54,2010,1,7,16,27,6,6,-0.740741,-20,0.166667,1,0.166667,1,36047005400,11209
54,2010,2,23,7,14,6,6,0.642857,9,2.833333,17,2.833333,17,36047005400,11209
54,2010,3,8,23,4,11,11,1,4,-0.272727,-3,-0.272727,-3,36047005400,11209
54,2010,4,3,8,5,2,2,-0.4,-2,0.5,1,0.5,1,36047005400,11209
54,2010,5,5,3,6,7,7,-0.166667,-1,-0.285714,-2,-0.285714,-2,36047005400,11209
58,2001,0,16,16,16,16,16,0,0,0,0,0,0,36047005800,11209
58,2001,1,15,16,15,15,15,0,0,0,0,0,0,36047005800,11209
58,2001,2,12,15,12,12,12,0,0,0,0,0,0,36047005800,11209
58,2001,3,15,12,15,15,15,0,0,0,0,0,0,36047005800,11209
58,2001,4,8,15,8,8,8,0,0,0,0,0,0,36047005800,11209
58,2001,5,7,8,7,7,7,0,0,0,0,0,0,36047005800,11209
58,2002,0,16,16,16,16,16,0,0,0,0,0,0,36047005800,11209
58,2002,1,19,16,15,19,19,0.266667,4,0,0,0,0,36047005800,11209
58,2002,2,13,19,12,13,13,0.083333,1,0,0,0,0,36047005800,11209
58,2002,3,15,13,15,15,15,0,0,0,0,0,0,36047005800,11209
58,2002,4,14,15,8,14,14,0.75,6,0,0,0,0,36047005800,11209
58,2002,5,9,14,7,9,9,0.285714,2,0,0,0,0,36047005800,11209
58,2003,0,10,10,16,10,10,-0.375,-6,0,0,0,0,36047005800,11209
58,2003,1,17,10,19,17,17,-0.105263,-2,0,0,0,0,36047005800,11209
58,2003,2,15,17,13,15,15,0.153846,2,0,0,0,0,36047005800,11209
58,2003,3,11,15,15,11,11,-0.266667,-4,0,0,0,0,36047005800,11209
58,2003,4,13,11,14,13,13,-0.071429,-1,0,0,0,0,36047005800,11209
58,2003,5,15,13,9,15,15,0.666667,6,0,0,0,0,36047005800,11209
58,2004,0,9,9,10,16,16,-0.1,-1,-0.4375,-7,-0.4375,-7,36047005800,11209
58,2004,1,14,9,17,15,15,-0.176471,-3,-0.066667,-1,-0.066667,-1,36047005800,11209
58,2004,2,16,14,15,12,12,0.066667,1,0.333333,4,0.333333,4,36047005800,11209
58,2004,3,10,16,11,15,15,-0.090909,-1,-0.333333,-5,-0.333333,-5,36047005800,11209
58,2004,4,8,10,13,8,8,-0.384615,-5,0,0,0,0,36047005800,11209
58,2004,5,9,8,15,7,7,-0.4,-6,0.285714,2,0.285714,2,36047005800,11209
58,2005,0,9,9,9,16,16,0,0,-0.4375,-7,-0.4375,-7,36047005800,11209
58,2005,1,11,9,14,19,19,-0.214286,-3,-0.421053,-8,-0.421053,-8,36047005800,11209
58,2005,2,11,11,16,13,13,-0.3125,-5,-0.153846,-2,-0.153846,-2,36047005800,11209
58,2005,3,11,11,10,15,15,0.1,1,-0.266667,-4,-0.266667,-4,36047005800,11209
58,2005,4,10,11,8,14,14,0.25,2,-0.285714,-4,-0.285714,-4,36047005800,11209
58,2005,5,7,10,9,9,9,-0.222222,-2,-0.222222,-2,-0.222222,-2,36047005800,11209
58,2006,0,9,9,9,10,10,0,0,-0.1,-1,-0.1,-1,36047005800,11209
58,2006,1,7,9,11,17,17,-0.363636,-4,-0.588235,-10,-0.588235,-10,36047005800,11209
58,2006,2,9,7,11,15,15,-0.181818,-2,-0.4,-6,-0.4,-6,36047005800,11209
58,2006,3,8,9,11,11,11,-0.272727,-3,-0.272727,-3,-0.272727,-3,36047005800,11209
58,2006,4,14,8,10,13,13,0.4,4,0.076923,1,0.076923,1,36047005800,11209
58,2006,5,5,14,7,15,15,-0.285714,-2,-0.666667,-10,-0.666667,-10,36047005800,11209
58,2007,0,20,20,9,9,9,1.222222,11,1.222222,11,1.222222,11,36047005800,11209
58,2007,1,9,20,7,14,14,0.285714,2,-0.357143,-5,-0.357143,-5,36047005800,11209
58,2007,2,4,9,9,16,16,-0.555556,-5,-0.75,-12,-0.75,-12,36047005800,11209
58,2007,3,9,4,8,10,10,0.125,1,-0.1,-1,-0.1,-1,36047005800,11209
58,2007,4,7,9,14,8,8,-0.5,-7,-0.125,-1,-0.125,-1,36047005800,11209
58,2007,5,11,7,5,9,9,1.2,6,0.222222,2,0.222222,2,36047005800,11209
58,2008,0,24,24,20,9,9,0.2,4,1.666667,15,1.666667,15,36047005800,11209
58,2008,1,15,24,9,11,11,0.666667,6,0.363636,4,0.363636,4,36047005800,11209
58,2008,2,10,15,4,11,11,1.5,6,-0.090909,-1,-0.090909,-1,36047005800,11209
58,2008,3,5,10,9,11,11,-0.444444,-4,-0.545455,-6,-0.545455,-6,36047005800,11209
58,2008,4,6,5,7,10,10,-0.142857,-1,-0.4,-4,-0.4,-4,36047005800,11209
58,2008,5,6,6,11,7,7,-0.454545,-5,-0.142857,-1,-0.142857,-1,36047005800,11209
58,2009,0,23,23,24,9,9,-0.041667,-1,1.555556,14,1.555556,14,36047005800,11209
58,2009,1,27,23,15,7,7,0.8,12,2.857143,20,2.857143,20,36047005800,11209
58,2009,2,19,27,10,9,9,0.9,9,1.111111,10,1.111111,10,36047005800,11209
58,2009,3,8,19,5,8,8,0.6,3,0,0,0,0,36047005800,11209
58,2009,4,11,8,6,14,14,0.833333,5,-0.214286,-3,-0.214286,-3,36047005800,11209
58,2009,5,13,11,6,5,5,1.166667,7,1.6,8,1.6,8,36047005800,11209
58,2010,0,33,33,23,20,20,0.434783,10,0.65,13,0.65,13,36047005800,11209
58,2010,1,22,33,27,9,9,-0.185185,-5,1.444444,13,1.444444,13,36047005800,11209
58,2010,2,22,22,19,4,4,0.157895,3,4.5,18,4.5,18,36047005800,11209
58,2010,3,17,22,8,9,9,1.125,9,0.888889,8,0.888889,8,36047005800,11209
58,2010,4,8,17,11,7,7,-0.272727,-3,0.142857,1,0.142857,1,36047005800,11209
58,2010,5,9,8,13,11,11,-0.307692,-4,-0.181818,-2,-0.181818,-2,36047005800,11209
60,2001,0,21,21,21,21,21,0,0,0,0,0,0,36047006000,11209
60,2001,1,24,21,24,24,24,0,0,0,0,0,0,36047006000,11209
60,2001,2,23,24,23,23,23,0,0,0,0,0,0,36047006000,11209
60,2001,3,19,23,19,19,19,0,0,0,0,0,0,36047006000,11209
60,2001,4,14,19,14,14,14,0,0,0,0,0,0,36047006000,11209
60,2001,5,19,14,19,19,19,0,0,0,0,0,0,36047006000,11209
60,2002,0,23,23,21,23,23,0.095238,2,0,0,0,0,36047006000,11209
60,2002,1,17,23,24,17,17,-0.291667,-7,0,0,0,0,36047006000,11209
60,2002,2,21,17,23,21,21,-0.086957,-2,0,0,0,0,36047006000,11209
60,2002,3,21,21,19,21,21,0.105263,2,0,0,0,0,36047006000,11209
60,2002,4,13,21,14,13,13,-0.071429,-1,0,0,0,0,36047006000,11209
60,2002,5,13,13,19,13,13,-0.315789,-6,0,0,0,0,36047006000,11209
60,2003,0,19,19,23,19,19,-0.173913,-4,0,0,0,0,36047006000,11209
60,2003,1,22,19,17,22,22,0.294118,5,0,0,0,0,36047006000,11209
60,2003,2,16,22,21,16,16,-0.238095,-5,0,0,0,0,36047006000,11209
60,2003,3,26,16,21,26,26,0.238095,5,0,0,0,0,36047006000,11209
60,2003,4,15,26,13,15,15,0.153846,2,0,0,0,0,36047006000,11209
60,2003,5,14,15,13,14,14,0.076923,1,0,0,0,0,36047006000,11209
60,2004,0,15,15,19,21,21,-0.210526,-4,-0.285714,-6,-0.285714,-6,36047006000,11209
60,2004,1,18,15,22,24,24,-0.181818,-4,-0.25,-6,-0.25,-6,36047006000,11209
60,2004,2,21,18,16,23,23,0.3125,5,-0.086957,-2,-0.086957,-2,36047006000,11209
60,2004,3,11,21,26,19,19,-0.576923,-15,-0.421053,-8,-0.421053,-8,36047006000,11209
60,2004,4,27,11,15,14,14,0.8,12,0.928571,13,0.928571,13,36047006000,11209
60,2004,5,18,27,14,19,19,0.285714,4,-0.052632,-1,-0.052632,-1,36047006000,11209
60,2005,0,15,15,15,23,23,0,0,-0.347826,-8,-0.347826,-8,36047006000,11209
60,2005,1,11,15,18,17,17,-0.388889,-7,-0.352941,-6,-0.352941,-6,36047006000,11209
60,2005,2,18,11,21,21,21,-0.142857,-3,-0.142857,-3,-0.142857,-3,36047006000,11209
60,2005,3,22,18,11,21,21,1,11,0.047619,1,0.047619,1,36047006000,11209
60,2005,4,10,22,27,13,13,-0.62963,-17,-0.230769,-3,-0.230769,-3,36047006000,11209
60,2005,5,24,10,18,13,13,0.333333,6,0.846154,11,0.846154,11,36047006000,11209
60,2006,0,24,24,15,19,19,0.6,9,0.263158,5,0.263158,5,36047006000,11209
60,2006,1,14,24,11,22,22,0.272727,3,-0.363636,-8,-0.363636,-8,36047006000,11209
60,2006,2,11,14,18,16,16,-0.388889,-7,-0.3125,-5,-0.3125,-5,36047006000,11209
60,2006,3,18,11,22,26,26,-0.181818,-4,-0.307692,-8,-0.307692,-8,36047006000,11209
60,2006,4,19,18,10,15,15,0.9,9,0.266667,4,0.266667,4,36047006000,11209
60,2006,5,10,19,24,14,14,-0.583333,-14,-0.285714,-4,-0.285714,-4,36047006000,11209
60,2007,0,24,24,24,15,15,0,0,0.6,9,0.6,9,36047006000,11209
60,2007,1,23,24,14,18,18,0.642857,9,0.277778,5,0.277778,5,36047006000,11209
60,2007,2,13,23,11,21,21,0.181818,2,-0.380952,-8,-0.380952,-8,36047006000,11209
60,2007,3,10,13,18,11,11,-0.444444,-8,-0.090909,-1,-0.090909,-1,36047006000,11209
60,2007,4,13,10,19,27,27,-0.315789,-6,-0.518519,-14,-0.518519,-14,36047006000,11209
60,2007,5,20,13,10,18,18,1,10,0.111111,2,0.111111,2,36047006000,11209
60,2008,0,27,27,24,15,15,0.125,3,0.8,12,0.8,12,36047006000,11209
60,2008,1,25,27,23,11,11,0.086957,2,1.272727,14,1.272727,14,36047006000,11209
60,2008,2,28,25,13,18,18,1.153846,15,0.555556,10,0.555556,10,36047006000,11209
60,2008,3,14,28,10,22,22,0.4,4,-0.363636,-8,-0.363636,-8,36047006000,11209
60,2008,4,7,14,13,10,10,-0.461538,-6,-0.3,-3,-0.3,-3,36047006000,11209
60,2008,5,11,7,20,24,24,-0.45,-9,-0.541667,-13,-0.541667,-13,36047006000,11209
60,2009,0,24,24,27,24,24,-0.111111,-3,0,0,0,0,36047006000,11209
60,2009,1,32,24,25,14,14,0.28,7,1.285714,18,1.285714,18,36047006000,11209
60,2009,2,32,32,28,11,11,0.142857,4,1.909091,21,1.909091,21,36047006000,11209
60,2009,3,32,32,14,18,18,1.285714,18,0.777778,14,0.777778,14,36047006000,11209
60,2009,4,24,32,7,19,19,2.428571,17,0.263158,5,0.263158,5,36047006000,11209
60,2009,5,24,24,11,10,10,1.181818,13,1.4,14,1.4,14,36047006000,11209
60,2010,0,35,35,24,24,24,0.458333,11,0.458333,11,0.458333,11,36047006000,11209
60,2010,1,32,35,32,23,23,0,0,0.391304,9,0.391304,9,36047006000,11209
60,2010,2,35,32,32,13,13,0.09375,3,1.692308,22,1.692308,22,36047006000,11209
60,2010,3,33,35,32,10,10,0.03125,1,2.3,23,2.3,23,36047006000,11209
60,2010,4,30,33,24,13,13,0.25,6,1.307692,17,1.307692,17,36047006000,11209
60,2010,5,26,30,24,20,20,0.083333,2,0.3,6,0.3,6,36047006000,11209
62,2001,0,26,26,26,26,26,0,0,0,0,0,0,36047006200,11209
62,2001,1,33,26,33,33,33,0,0,0,0,0,0,36047006200,11209
62,2001,2,28,33,28,28,28,0,0,0,0,0,0,36047006200,11209
62,2001,3,34,28,34,34,34,0,0,0,0,0,0,36047006200,11209
62,2001,4,22,34,22,22,22,0,0,0,0,0,0,36047006200,11209
62,2001,5,16,22,16,16,16,0,0,0,0,0,0,36047006200,11209
62,2002,0,16,16,26,16,16,-0.384615,-10,0,0,0,0,36047006200,11209
62,2002,1,22,16,33,22,22,-0.333333,-11,0,0,0,0,36047006200,11209
62,2002,2,35,22,28,35,35,0.25,7,0,0,0,0,36047006200,11209
62,2002,3,30,35,34,30,30,-0.117647,-4,0,0,0,0,36047006200,11209
62,2002,4,30,30,22,30,30,0.363636,8,0,0,0,0,36047006200,11209
62,2002,5,19,30,16,19,19,0.1875,3,0,0,0,0,36047006200,11209
62,2003,0,21,21,16,21,21,0.3125,5,0,0,0,0,36047006200,11209
62,2003,1,20,21,22,20,20,-0.090909,-2,0,0,0,0,36047006200,11209
62,2003,2,19,20,35,19,19,-0.457143,-16,0,0,0,0,36047006200,11209
62,2003,3,25,19,30,25,25,-0.166667,-5,0,0,0,0,36047006200,11209
62,2003,4,27,25,30,27,27,-0.1,-3,0,0,0,0,36047006200,11209
62,2003,5,31,27,19,31,31,0.631579,12,0,0,0,0,36047006200,11209
62,2004,0,14,14,21,26,26,-0.333333,-7,-0.461538,-12,-0.461538,-12,36047006200,11209
62,2004,1,24,14,20,33,33,0.2,4,-0.272727,-9,-0.272727,-9,36047006200,11209
62,2004,2,20,24,19,28,28,0.052632,1,-0.285714,-8,-0.285714,-8,36047006200,11209
62,2004,3,24,20,25,34,34,-0.04,-1,-0.294118,-10,-0.294118,-10,36047006200,11209
62,2004,4,28,24,27,22,22,0.037037,1,0.272727,6,0.272727,6,36047006200,11209
62,2004,5,28,28,31,16,16,-0.096774,-3,0.75,12,0.75,12,36047006200,11209
62,2005,0,14,14,14,16,16,0,0,-0.125,-2,-0.125,-2,36047006200,11209
62,2005,1,14,14,24,22,22,-0.416667,-10,-0.363636,-8,-0.363636,-8,36047006200,11209
62,2005,2,17,14,20,35,35,-0.15,-3,-0.514286,-18,-0.514286,-18,36047006200,11209
62,2005,3,14,17,24,30,30,-0.416667,-10,-0.533333,-16,-0.533333,-16,36047006200,11209
62,2005,4,19,14,28,30,30,-0.321429,-9,-0.366667,-11,-0.366667,-11,36047006200,11209
62,2005,5,26,19,28,19,19,-0.071429,-2,0.368421,7,0.368421,7,36047006200,11209
62,2006,0,26,26,14,21,21,0.857143,12,0.238095,5,0.238095,5,36047006200,11209
62,2006,1,19,26,14,20,20,0.357143,5,-0.05,-1,-0.05,-1,36047006200,11209
62,2006,2,11,19,17,19,19,-0.352941,-6,-0.421053,-8,-0.421053,-8,36047006200,11209
62,2006,3,17,11,14,25,25,0.214286,3,-0.32,-8,-0.32,-8,36047006200,11209
62,2006,4,11,17,19,27,27,-0.421053,-8,-0.592593,-16,-0.592593,-16,36047006200,11209
62,2006,5,20,11,26,31,31,-0.230769,-6,-0.354839,-11,-0.354839,-11,36047006200,11209
62,2007,0,30,30,26,14,14,0.153846,4,1.142857,16,1.142857,16,36047006200,11209
62,2007,1,27,30,19,24,24,0.421053,8,0.125,3,0.125,3,36047006200,11209
62,2007,2,17,27,11,20,20,0.545455,6,-0.15,-3,-0.15,-3,36047006200,11209
62,2007,3,9,17,17,24,24,-0.470588,-8,-0.625,-15,-0.625,-15,36047006200,11209
62,2007,4,15,9,11,28,28,0.363636,4,-0.464286,-13,-0.464286,-13,36047006200,11209
62,2007,5,11,15,20,28,28,-0.45,-9,-0.607143,-17,-0.607143,-17,36047006200,11209
62,2008,0,35,35,30,14,14,0.166667,5,1.5,21,1.5,21,36047006200,11209
62,2008,1,32,35,27,14,14,0.185185,5,1.285714,18,1.285714,18,36047006200,11209
62,2008,2,30,32,17,17,17,0.764706,13,0.764706,13,0.764706,13,36047006200,11209
62,2008,3,18,30,9,14,14,1,9,0.285714,4,0.285714,4,36047006200,11209
62,2008,4,12,18,15,19,19,-0.2,-3,-0.368421,-7,-0.368421,-7,36047006200,11209
62,2008,5,14,12,11,26,26,0.272727,3,-0.461538,-12,-0.461538,-12,36047006200,11209
62,2009,0,33,33,35,26,26,-0.057143,-2,0.269231,7,0.269231,7,36047006200,11209
62,2009,1,34,33,32,19,19,0.0625,2,0.789474,15,0.789474,15,36047006200,11209
62,2009,2,34,34,30,11,11,0.133333,4,2.090909,23,2.090909,23,36047006200,11209
62,2009,3,35,34,18,17,17,0.944444,17,1.058824,18,1.058824,18,36047006200,11209
62,2009,4,29,35,12,11,11,1.416667,17,1.636364,18,1.636364,18,36047006200,11209
62,2009,5,30,29,14,20,20,1.142857,16,0.5,10,0.5,10,36047006200,11209
62,2010,0,27,27,33,30,30,-0.181818,-6,-0.1,-3,-0.1,-3,36047006200,11209
62,2010,1,32,27,34,27,27,-0.058824,-2,0.185185,5,0.185185,5,36047006200,11209
62,2010,2,35,32,34,17,17,0.029412,1,1.058824,18,1.058824,18,36047006200,11209
62,2010,3,35,35,35,9,9,0,0,2.888889,26,2.888889,26,36047006200,11209
62,2010,4,32,35,29,15,15,0.103448,3,1.133333,17,1.133333,17,36047006200,11209
62,2010,5,31,32,30,11,11,0.033333,1,1.818182,20,1.818182,20,36047006200,11209
64,2001,0,22,22,22,22,22,0,0,0,0,0,0,36047006400,11209
64,2001,1,27,22,27,27,27,0,0,0,0,0,0,36047006400,11209
64,2001,2,29,27,29,29,29,0,0,0,0,0,0,36047006400,11209
64,2001,3,23,29,23,23,23,0,0,0,0,0,0,36047006400,11209
64,2001,4,21,23,21,21,21,0,0,0,0,0,0,36047006400,11209
64,2001,5,24,21,24,24,24,0,0,0,0,0,0,36047006400,11209
64,2002,0,19,19,22,19,19,-0.136364,-3,0,0,0,0,36047006400,11209
64,2002,1,22,19,27,22,22,-0.185185,-5,0,0,0,0,36047006400,11209
64,2002,2,28,22,29,28,28,-0.034483,-1,0,0,0,0,36047006400,11209
64,2002,3,31,28,23,31,31,0.347826,8,0,0,0,0,36047006400,11209
64,2002,4,27,31,21,27,27,0.285714,6,0,0,0,0,36047006400,11209
64,2002,5,20,27,24,20,20,-0.166667,-4,0,0,0,0,36047006400,11209
64,2003,0,16,16,19,16,16,-0.157895,-3,0,0,0,0,36047006400,11209
64,2003,1,17,16,22,17,17,-0.227273,-5,0,0,0,0,36047006400,11209
64,2003,2,17,17,28,17,17,-0.392857,-11,0,0,0,0,36047006400,11209
64,2003,3,26,17,31,26,26,-0.16129,-5,0,0,0,0,36047006400,11209
64,2003,4,30,26,27,30,30,0.111111,3,0,0,0,0,36047006400,11209
64,2003,5,28,30,20,28,28,0.4,8,0,0,0,0,36047006400,11209
64,2004,0,23,23,16,22,22,0.4375,7,0.045455,1,0.045455,1,36047006400,11209
64,2004,1,16,23,17,27,27,-0.058824,-1,-0.407407,-11,-0.407407,-11,36047006400,11209
64,2004,2,19,16,17,29,29,0.117647,2,-0.344828,-10,-0.344828,-10,36047006400,11209
64,2004,3,18,19,26,23,23,-0.307692,-8,-0.217391,-5,-0.217391,-5,36047006400,11209
64,2004,4,31,18,30,21,21,0.033333,1,0.47619,10,0.47619,10,36047006400,11209
64,2004,5,33,31,28,24,24,0.178571,5,0.375,9,0.375,9,36047006400,11209
64,2005,0,24,24,23,19,19,0.043478,1,0.263158,5,0.263158,5,36047006400,11209
64,2005,1,28,24,16,22,22,0.75,12,0.272727,6,0.272727,6,36047006400,11209
64,2005,2,17,28,19,28,28,-0.105263,-2,-0.392857,-11,-0.392857,-11,36047006400,11209
64,2005,3,18,17,18,31,31,0,0,-0.419355,-13,-0.419355,-13,36047006400,11209
64,2005,4,21,18,31,27,27,-0.322581,-10,-0.222222,-6,-0.222222,-6,36047006400,11209
64,2005,5,32,21,33,20,20,-0.030303,-1,0.6,12,0.6,12,36047006400,11209
64,2006,0,36,36,24,16,16,0.5,12,1.25,20,1.25,20,36047006400,11209
64,2006,1,19,36,28,17,17,-0.321429,-9,0.117647,2,0.117647,2,36047006400,11209
64,2006,2,21,19,17,17,17,0.235294,4,0.235294,4,0.235294,4,36047006400,11209
64,2006,3,19,21,18,26,26,0.055556,1,-0.269231,-7,-0.269231,-7,36047006400,11209
64,2006,4,18,19,21,30,30,-0.142857,-3,-0.4,-12,-0.4,-12,36047006400,11209
64,2006,5,21,18,32,28,28,-0.34375,-11,-0.25,-7,-0.25,-7,36047006400,11209
64,2007,0,20,20,36,23,23,-0.444444,-16,-0.130435,-3,-0.130435,-3,36047006400,11209
64,2007,1,28,20,19,16,16,0.473684,9,0.75,12,0.75,12,36047006400,11209
64,2007,2,21,28,21,19,19,0,0,0.105263,2,0.105263,2,36047006400,11209
64,2007,3,15,21,19,18,18,-0.210526,-4,-0.166667,-3,-0.166667,-3,36047006400,11209
64,2007,4,15,15,18,31,31,-0.166667,-3,-0.516129,-16,-0.516129,-16,36047006400,11209
64,2007,5,16,15,21,33,33,-0.238095,-5,-0.515152,-17,-0.515152,-17,36047006400,11209
64,2008,0,34,34,20,24,24,0.7,14,0.416667,10,0.416667,10,36047006400,11209
64,2008,1,18,34,28,28,28,-0.357143,-10,-0.357143,-10,-0.357143,-10,36047006400,11209
64,2008,2,29,18,21,17,17,0.380952,8,0.705882,12,0.705882,12,36047006400,11209
64,2008,3,23,29,15,18,18,0.533333,8,0.277778,5,0.277778,5,36047006400,11209
64,2008,4,16,23,15,21,21,0.066667,1,-0.238095,-5,-0.238095,-5,36047006400,11209
64,2008,5,16,16,16,32,32,0,0,-0.5,-16,-0.5,-16,36047006400,11209
64,2009,0,34,34,34,36,36,0,0,-0.055556,-2,-0.055556,-2,36047006400,11209
64,2009,1,37,34,18,19,19,1.055556,19,0.947368,18,0.947368,18,36047006400,11209
64,2009,2,22,37,29,21,21,-0.241379,-7,0.047619,1,0.047619,1,36047006400,11209
64,2009,3,32,22,23,19,19,0.391304,9,0.684211,13,0.684211,13,36047006400,11209
64,2009,4,35,32,16,18,18,1.1875,19,0.944444,17,0.944444,17,36047006400,11209
64,2009,5,34,35,16,21,21,1.125,18,0.619048,13,0.619048,13,36047006400,11209
64,2010,0,34,34,34,20,20,0,0,0.7,14,0.7,14,36047006400,11209
64,2010,1,37,34,37,28,28,0,0,0.321429,9,0.321429,9,36047006400,11209
64,2010,2,32,37,22,21,21,0.454545,10,0.52381,11,0.52381,11,36047006400,11209
64,2010,3,22,32,32,15,15,-0.3125,-10,0.466667,7,0.466667,7,36047006400,11209
64,2010,4,34,22,35,15,15,-0.028571,-1,1.266667,19,1.266667,19,36047006400,11209
64,2010,5,36,34,34,16,16,0.058824,2,1.25,20,1.25,20,36047006400,11209
66,2001,0,32,32,32,32,32,0,0,0,0,0,0,36047006600,11209
66,2001,1,26,32,26,26,26,0,0,0,0,0,0,36047006600,11209
66,2001,2,34,26,34,34,34,0,0,0,0,0,0,36047006600,11209
66,2001,3,25,34,25,25,25,0,0,0,0,0,0,36047006600,11209
66,2001,4,18,25,18,18,18,0,0,0,0,0,0,36047006600,11209
66,2001,5,26,18,26,26,26,0,0,0,0,0,0,36047006600,11209
66,2002,0,21,21,32,21,21,-0.34375,-11,0,0,0,0,36047006600,11209
66,2002,1,36,21,26,36,36,0.384615,10,0,0,0,0,36047006600,11209
66,2002,2,31,36,34,31,31,-0.088235,-3,0,0,0,0,36047006600,11209
66,2002,3,33,31,25,33,33,0.32,8,0,0,0,0,36047006600,11209
66,2002,4,22,33,18,22,22,0.222222,4,0,0,0,0,36047006600,11209
66,2002,5,16,22,26,16,16,-0.384615,-10,0,0,0,0,36047006600,11209
66,2003,0,32,32,21,32,32,0.52381,11,0,0,0,0,36047006600,11209
66,2003,1,25,32,36,25,25,-0.305556,-11,0,0,0,0,36047006600,11209
66,2003,2,34,25,31,34,34,0.096774,3,0,0,0,0,36047006600,11209
66,2003,3,34,34,33,34,34,0.030303,1,0,0,0,0,36047006600,11209
66,2003,4,31,34,22,31,31,0.409091,9,0,0,0,0,36047006600,11209
66,2003,5,25,31,16,25,25,0.5625,9,0,0,0,0,36047006600,11209
66,2004,0,29,29,32,32,32,-0.09375,-3,-0.09375,-3,-0.09375,-3,36047006600,11209
66,2004,1,28,29,25,26,26,0.12,3,0.076923,2,0.076923,2,36047006600,11209
66,2004,2,21,28,34,34,34,-0.382353,-13,-0.382353,-13,-0.382353,-13,36047006600,11209
66,2004,3,34,21,34,25,25,0,0,0.36,9,0.36,9,36047006600,11209
66,2004,4,36,34,31,18,18,0.16129,5,1,18,1,18,36047006600,11209
66,2004,5,29,36,25,26,26,0.16,4,0.115385,3,0.115385,3,36047006600,11209
66,2005,0,28,28,29,21,21,-0.034483,-1,0.333333,7,0.333333,7,36047006600,11209
66,2005,1,27,28,28,36,36,-0.035714,-1,-0.25,-9,-0.25,-9,36047006600,11209
66,2005,2,27,27,21,31,31,0.285714,6,-0.129032,-4,-0.129032,-4,36047006600,11209
66,2005,3,24,27,34,33,33,-0.294118,-10,-0.272727,-9,-0.272727,-9,36047006600,11209
66,2005,4,36,24,36,22,22,0,0,0.636364,14,0.636364,14,36047006600,11209
66,2005,5,33,36,29,16,16,0.137931,4,1.0625,17,1.0625,17,36047006600,11209
66,2006,0,32,32,28,32,32,0.142857,4,0,0,0,0,36047006600,11209
66,2006,1,32,32,27,25,25,0.185185,5,0.28,7,0.28,7,36047006600,11209
66,2006,2,26,32,27,34,34,-0.037037,-1,-0.235294,-8,-0.235294,-8,36047006600,11209
66,2006,3,26,26,24,34,34,0.083333,2,-0.235294,-8,-0.235294,-8,36047006600,11209
66,2006,4,27,26,36,31,31,-0.25,-9,-0.129032,-4,-0.129032,-4,36047006600,11209
66,2006,5,35,27,33,25,25,0.060606,2,0.4,10,0.4,10,36047006600,11209
66,2007,0,30,30,32,29,29,-0.0625,-2,0.034483,1,0.034483,1,36047006600,11209
66,2007,1,36,30,32,28,28,0.125,4,0.285714,8,0.285714,8,36047006600,11209
66,2007,2,32,36,26,21,21,0.230769,6,0.52381,11,0.52381,11,36047006600,11209
66,2007,3,25,32,26,34,34,-0.038462,-1,-0.264706,-9,-0.264706,-9,36047006600,11209
66,2007,4,26,25,27,36,36,-0.037037,-1,-0.277778,-10,-0.277778,-10,36047006600,11209
66,2007,5,29,26,35,29,29,-0.171429,-6,0,0,0,0,36047006600,11209
66,2008,0,24,24,30,28,28,-0.2,-6,-0.142857,-4,-0.142857,-4,36047006600,11209
66,2008,1,32,24,36,27,27,-0.111111,-4,0.185185,5,0.185185,5,36047006600,11209
66,2008,2,31,32,32,27,27,-0.03125,-1,0.148148,4,0.148148,4,36047006600,11209
66,2008,3,30,31,25,24,24,0.2,5,0.25,6,0.25,6,36047006600,11209
66,2008,4,18,30,26,36,36,-0.307692,-8,-0.5,-18,-0.5,-18,36047006600,11209
66,2008,5,26,18,29,33,33,-0.103448,-3,-0.212121,-7,-0.212121,-7,36047006600,11209
66,2009,0,30,30,24,32,32,0.25,6,-0.0625,-2,-0.0625,-2,36047006600,11209
66,2009,1,26,30,32,32,32,-0.1875,-6,-0.1875,-6,-0.1875,-6,36047006600,11209
66,2009,2,34,26,31,26,26,0.096774,3,0.307692,8,0.307692,8,36047006600,11209
66,2009,3,27,34,30,26,26,-0.1,-3,0.038462,1,0.038462,1,36047006600,11209
66,2009,4,29,27,18,27,27,0.611111,11,0.074074,2,0.074074,2,36047006600,11209
66,2009,5,23,29,26,35,35,-0.115385,-3,-0.342857,-12,-0.342857,-12,36047006600,11209
66,2010,0,37,37,30,30,30,0.233333,7,0.233333,7,0.233333,7,36047006600,11209
66,2010,1,32,37,26,36,36,0.230769,6,-0.111111,-4,-0.111111,-4,36047006600,11209
66,2010,2,29,32,34,32,32,-0.147059,-5,-0.09375,-3,-0.09375,-3,36047006600,11209
66,2010,3,35,29,27,25,25,0.296296,8,0.4,10,0.4,10,36047006600,11209
66,2010,4,24,35,29,26,26,-0.172414,-5,-0.076923,-2,-0.076923,-2,36047006600,11209
66,2010,5,33,24,23,29,29,0.434783,10,0.137931,4,0.137931,4,36047006600,11209
68,2001,0,46,46,46,46,46,0,0,0,0,0,0,36047006800,11209
68,2001,1,56,46,56,56,56,0,0,0,0,0,0,36047006800,11209
68,2001,2,56,56,56,56,56,0,0,0,0,0,0,36047006800,11209
68,2001,3,66,56,66,66,66,0,0,0,0,0,0,36047006800,11209
68,2001,4,42,66,42,42,42,0,0,0,0,0,0,36047006800,11209
68,2001,5,53,42,53,53,53,0,0,0,0,0,0,36047006800,11209
68,2002,0,56,56,46,56,56,0.217391,10,0,0,0,0,36047006800,11209
68,2002,1,49,56,56,49,49,-0.125,-7,0,0,0,0,36047006800,11209
68,2002,2,55,49,56,55,55,-0.017857,-1,0,0,0,0,36047006800,11209
68,2002,3,59,55,66,59,59,-0.106061,-7,0,0,0,0,36047006800,11209
68,2002,4,71,59,42,71,71,0.690476,29,0,0,0,0,36047006800,11209
68,2002,5,47,71,53,47,47,-0.113208,-6,0,0,0,0,36047006800,11209
68,2003,0,50,50,56,50,50,-0.107143,-6,0,0,0,0,36047006800,11209
68,2003,1,61,50,49,61,61,0.244898,12,0,0,0,0,36047006800,11209
68,2003,2,50,61,55,50,50,-0.090909,-5,0,0,0,0,36047006800,11209
68,2003,3,54,50,59,54,54,-0.084746,-5,0,0,0,0,36047006800,11209
68,2003,4,62,54,71,62,62,-0.126761,-9,0,0,0,0,36047006800,11209
68,2003,5,70,62,47,70,70,0.489362,23,0,0,0,0,36047006800,11209
68,2004,0,56,56,50,46,46,0.12,6,0.217391,10,0.217391,10,36047006800,11209
68,2004,1,52,56,61,56,56,-0.147541,-9,-0.071429,-4,-0.071429,-4,36047006800,11209
68,2004,2,65,52,50,56,56,0.3,15,0.160714,9,0.160714,9,36047006800,11209
68,2004,3,42,65,54,66,66,-0.222222,-12,-0.363636,-24,-0.363636,-24,36047006800,11209
68,2004,4,51,42,62,42,42,-0.177419,-11,0.214286,9,0.214286,9,36047006800,11209
68,2004,5,56,51,70,53,53,-0.2,-14,0.056604,3,0.056604,3,36047006800,11209
68,2005,0,67,67,56,56,56,0.196429,11,0.196429,11,0.196429,11,36047006800,11209
68,2005,1,62,67,52,49,49,0.192308,10,0.265306,13,0.265306,13,36047006800,11209
68,2005,2,49,62,65,55,55,-0.246154,-16,-0.109091,-6,-0.109091,-6,36047006800,11209
68,2005,3,69,49,42,59,59,0.642857,27,0.169492,10,0.169492,10,36047006800,11209
68,2005,4,52,69,51,71,71,0.019608,1,-0.267606,-19,-0.267606,-19,36047006800,11209
68,2005,5,58,52,56,47,47,0.035714,2,0.234043,11,0.234043,11,36047006800,11209
68,2006,0,47,47,67,50,50,-0.298507,-20,-0.06,-3,-0.06,-3,36047006800,11209
68,2006,1,67,47,62,61,61,0.080645,5,0.098361,6,0.098361,6,36047006800,11209
68,2006,2,66,67,49,50,50,0.346939,17,0.32,16,0.32,16,36047006800,11209
68,2006,3,53,66,69,54,54,-0.231884,-16,-0.018519,-1,-0.018519,-1,36047006800,11209
68,2006,4,63,53,52,62,62,0.211538,11,0.016129,1,0.016129,1,36047006800,11209
68,2006,5,60,63,58,70,70,0.034483,2,-0.142857,-10,-0.142857,-10,36047006800,11209
68,2007,0,55,55,47,56,56,0.170213,8,-0.017857,-1,-0.017857,-1,36047006800,11209
68,2007,1,48,55,67,52,52,-0.283582,-19,-0.076923,-4,-0.076923,-4,36047006800,11209
68,2007,2,69,48,66,65,65,0.045455,3,0.061538,4,0.061538,4,36047006800,11209
68,2007,3,71,69,53,42,42,0.339623,18,0.690476,29,0.690476,29,36047006800,11209
68,2007,4,51,71,63,51,51,-0.190476,-12,0,0,0,0,36047006800,11209
68,2007,5,58,51,60,56,56,-0.033333,-2,0.035714,2,0.035714,2,36047006800,11209
68,2008,0,67,67,55,67,67,0.218182,12,0,0,0,0,36047006800,11209
68,2008,1,62,67,48,62,62,0.291667,14,0,0,0,0,36047006800,11209
68,2008,2,47,62,69,49,49,-0.318841,-22,-0.040816,-2,-0.040816,-2,36047006800,11209
68,2008,3,68,47,71,69,69,-0.042254,-3,-0.014493,-1,-0.014493,-1,36047006800,11209
68,2008,4,74,68,51,52,52,0.45098,23,0.423077,22,0.423077,22,36047006800,11209
68,2008,5,52,74,58,58,58,-0.103448,-6,-0.103448,-6,-0.103448,-6,36047006800,11209
68,2009,0,64,64,67,47,47,-0.044776,-3,0.361702,17,0.361702,17,36047006800,11209
68,2009,1,75,64,62,67,67,0.209677,13,0.119403,8,0.119403,8,36047006800,11209
68,2009,2,63,75,47,66,66,0.340426,16,-0.045455,-3,-0.045455,-3,36047006800,11209
68,2009,3,56,63,68,53,53,-0.176471,-12,0.056604,3,0.056604,3,36047006800,11209
68,2009,4,62,56,74,63,63,-0.162162,-12,-0.015873,-1,-0.015873,-1,36047006800,11209
68,2009,5,72,62,52,60,60,0.384615,20,0.2,12,0.2,12,36047006800,11209
68,2010,0,58,58,64,55,55,-0.09375,-6,0.054545,3,0.054545,3,36047006800,11209
68,2010,1,55,58,75,48,48,-0.266667,-20,0.145833,7,0.145833,7,36047006800,11209
68,2010,2,74,55,63,69,69,0.174603,11,0.072464,5,0.072464,5,36047006800,11209
68,2010,3,56,74,56,71,71,0,0,-0.211268,-15,-0.211268,-15,36047006800,11209
68,2010,4,55,56,62,51,51,-0.112903,-7,0.078431,4,0.078431,4,36047006800,11209
68,2010,5,61,55,72,58,58,-0.152778,-11,0.051724,3,0.051724,3,36047006800,11209
70,2001,0,21,21,21,21,21,0,0,0,0,0,0,36047007000,11220
70,2001,1,17,21,17,17,17,0,0,0,0,0,0,36047007000,11220
70,2001,2,22,17,22,22,22,0,0,0,0,0,0,36047007000,11220
70,2001,3,15,22,15,15,15,0,0,0,0,0,0,36047007000,11220
70,2001,4,13,15,13,13,13,0,0,0,0,0,0,36047007000,11220
70,2001,5,9,13,9,9,9,0,0,0,0,0,0,36047007000,11220
70,2002,0,14,14,21,14,14,-0.333333,-7,0,0,0,0,36047007000,11220
70,2002,1,21,14,17,21,21,0.235294,4,0,0,0,0,36047007000,11220
70,2002,2,17,21,22,17,17,-0.227273,-5,0,0,0,0,36047007000,11220
70,2002,3,19,17,15,19,19,0.266667,4,0,0,0,0,36047007000,11220
70,2002,4,13,19,13,13,13,0,0,0,0,0,0,36047007000,11220
70,2002,5,15,13,9,15,15,0.666667,6,0,0,0,0,36047007000,11220
70,2003,0,17,17,14,17,17,0.214286,3,0,0,0,0,36047007000,11220
70,2003,1,18,17,21,18,18,-0.142857,-3,0,0,0,0,36047007000,11220
70,2003,2,21,18,17,21,21,0.235294,4,0,0,0,0,36047007000,11220
70,2003,3,16,21,19,16,16,-0.157895,-3,0,0,0,0,36047007000,11220
70,2003,4,20,16,13,20,20,0.538462,7,0,0,0,0,36047007000,11220
70,2003,5,10,20,15,10,10,-0.333333,-5,0,0,0,0,36047007000,11220
70,2004,0,18,18,17,21,21,0.058824,1,-0.142857,-3,-0.142857,-3,36047007000,11220
70,2004,1,19,18,18,17,17,0.055556,1,0.117647,2,0.117647,2,36047007000,11220
70,2004,2,18,19,21,22,22,-0.142857,-3,-0.181818,-4,-0.181818,-4,36047007000,11220
70,2004,3,19,18,16,15,15,0.1875,3,0.266667,4,0.266667,4,36047007000,11220
70,2004,4,15,19,20,13,13,-0.25,-5,0.153846,2,0.153846,2,36047007000,11220
70,2004,5,19,15,10,9,9,0.9,9,1.111111,10,1.111111,10,36047007000,11220
70,2005,0,12,12,18,14,14,-0.333333,-6,-0.142857,-2,-0.142857,-2,36047007000,11220
70,2005,1,14,12,19,21,21,-0.263158,-5,-0.333333,-7,-0.333333,-7,36047007000,11220
70,2005,2,13,14,18,17,17,-0.277778,-5,-0.235294,-4,-0.235294,-4,36047007000,11220
70,2005,3,17,13,19,19,19,-0.105263,-2,-0.105263,-2,-0.105263,-2,36047007000,11220
70,2005,4,18,17,15,13,13,0.2,3,0.384615,5,0.384615,5,36047007000,11220
70,2005,5,10,18,19,15,15,-0.473684,-9,-0.333333,-5,-0.333333,-5,36047007000,11220
70,2006,0,19,19,12,17,17,0.583333,7,0.117647,2,0.117647,2,36047007000,11220
70,2006,1,17,19,14,18,18,0.214286,3,-0.055556,-1,-0.055556,-1,36047007000,11220
70,2006,2,15,17,13,21,21,0.153846,2,-0.285714,-6,-0.285714,-6,36047007000,11220
70,2006,3,14,15,17,16,16,-0.176471,-3,-0.125,-2,-0.125,-2,36047007000,11220
70,2006,4,18,14,18,20,20,0,0,-0.1,-2,-0.1,-2,36047007000,11220
70,2006,5,18,18,10,10,10,0.8,8,0.8,8,0.8,8,36047007000,11220
70,2007,0,13,13,19,18,18,-0.315789,-6,-0.277778,-5,-0.277778,-5,36047007000,11220
70,2007,1,19,13,17,19,19,0.117647,2,0,0,0,0,36047007000,11220
70,2007,2,15,19,15,18,18,0,0,-0.166667,-3,-0.166667,-3,36047007000,11220
70,2007,3,16,15,14,19,19,0.142857,2,-0.157895,-3,-0.157895,-3,36047007000,11220
70,2007,4,15,16,18,15,15,-0.166667,-3,0,0,0,0,36047007000,11220
70,2007,5,15,15,18,19,19,-0.166667,-3,-0.210526,-4,-0.210526,-4,36047007000,11220
70,2008,0,15,15,13,12,12,0.153846,2,0.25,3,0.25,3,36047007000,11220
70,2008,1,14,15,19,14,14,-0.263158,-5,0,0,0,0,36047007000,11220
70,2008,2,21,14,15,13,13,0.4,6,0.615385,8,0.615385,8,36047007000,11220
70,2008,3,13,21,16,17,17,-0.1875,-3,-0.235294,-4,-0.235294,-4,36047007000,11220
70,2008,4,14,13,15,18,18,-0.066667,-1,-0.222222,-4,-0.222222,-4,36047007000,11220
70,2008,5,16,14,15,10,10,0.066667,1,0.6,6,0.6,6,36047007000,11220
70,2009,0,10,10,15,19,19,-0.333333,-5,-0.473684,-9,-0.473684,-9,36047007000,11220
70,2009,1,18,10,14,17,17,0.285714,4,0.058824,1,0.058824,1,36047007000,11220
70,2009,2,14,18,21,15,15,-0.333333,-7,-0.066667,-1,-0.066667,-1,36047007000,11220
70,2009,3,20,14,13,14,14,0.538462,7,0.428571,6,0.428571,6,36047007000,11220
70,2009,4,11,20,14,18,18,-0.214286,-3,-0.388889,-7,-0.388889,-7,36047007000,11220
70,2009,5,14,11,16,18,18,-0.125,-2,-0.222222,-4,-0.222222,-4,36047007000,11220
70,2010,0,19,19,10,13,13,0.9,9,0.461538,6,0.461538,6,36047007000,11220
70,2010,1,11,19,18,19,19,-0.388889,-7,-0.421053,-8,-0.421053,-8,36047007000,11220
70,2010,2,20,11,14,15,15,0.428571,6,0.333333,5,0.333333,5,36047007000,11220
70,2010,3,13,20,20,16,16,-0.35,-7,-0.1875,-3,-0.1875,-3,36047007000,11220
70,2010,4,18,13,11,15,15,0.636364,7,0.2,3,0.2,3,36047007000,11220
70,2010,5,13,18,14,15,15,-0.071429,-1,-0.133333,-2,-0.133333,-2,36047007000,11220
72,2001,0,21,21,21,21,21,0,0,0,0,0,0,36047007200,11220
72,2001,1,23,21,23,23,23,0,0,0,0,0,0,36047007200,11220
72,2001,2,39,23,39,39,39,0,0,0,0,0,0,36047007200,11220
72,2001,3,28,39,28,28,28,0,0,0,0,0,0,36047007200,11220
72,2001,4,19,28,19,19,19,0,0,0,0,0,0,36047007200,11220
72,2001,5,26,19,26,26,26,0,0,0,0,0,0,36047007200,11220
72,2002,0,19,19,21,19,19,-0.095238,-2,0,0,0,0,36047007200,11220
72,2002,1,24,19,23,24,24,0.043478,1,0,0,0,0,36047007200,11220
72,2002,2,25,24,39,25,25,-0.358974,-14,0,0,0,0,36047007200,11220
72,2002,3,39,25,28,39,39,0.392857,11,0,0,0,0,36047007200,11220
72,2002,4,25,39,19,25,25,0.315789,6,0,0,0,0,36047007200,11220
72,2002,5,20,25,26,20,20,-0.230769,-6,0,0,0,0,36047007200,11220
72,2003,0,29,29,19,29,29,0.526316,10,0,0,0,0,36047007200,11220
72,2003,1,21,29,24,21,21,-0.125,-3,0,0,0,0,36047007200,11220
72,2003,2,25,21,25,25,25,0,0,0,0,0,0,36047007200,11220
72,2003,3,27,25,39,27,27,-0.307692,-12,0,0,0,0,36047007200,11220
72,2003,4,38,27,25,38,38,0.52,13,0,0,0,0,36047007200,11220
72,2003,5,24,38,20,24,24,0.2,4,0,0,0,0,36047007200,11220
72,2004,0,24,24,29,21,21,-0.172414,-5,0.142857,3,0.142857,3,36047007200,11220
72,2004,1,28,24,21,23,23,0.333333,7,0.217391,5,0.217391,5,36047007200,11220
72,2004,2,21,28,25,39,39,-0.16,-4,-0.461538,-18,-0.461538,-18,36047007200,11220
72,2004,3,22,21,27,28,28,-0.185185,-5,-0.214286,-6,-0.214286,-6,36047007200,11220
72,2004,4,20,22,38,19,19,-0.473684,-18,0.052632,1,0.052632,1,36047007200,11220
72,2004,5,30,20,24,26,26,0.25,6,0.153846,4,0.153846,4,36047007200,11220
72,2005,0,20,20,24,19,19,-0.166667,-4,0.052632,1,0.052632,1,36047007200,11220
72,2005,1,23,20,28,24,24,-0.178571,-5,-0.041667,-1,-0.041667,-1,36047007200,11220
72,2005,2,34,23,21,25,25,0.619048,13,0.36,9,0.36,9,36047007200,11220
72,2005,3,16,34,22,39,39,-0.272727,-6,-0.589744,-23,-0.589744,-23,36047007200,11220
72,2005,4,22,16,20,25,25,0.1,2,-0.12,-3,-0.12,-3,36047007200,11220
72,2005,5,19,22,30,20,20,-0.366667,-11,-0.05,-1,-0.05,-1,36047007200,11220
72,2006,0,28,28,20,29,29,0.4,8,-0.034483,-1,-0.034483,-1,36047007200,11220
72,2006,1,21,28,23,21,21,-0.086957,-2,0,0,0,0,36047007200,11220
72,2006,2,23,21,34,25,25,-0.323529,-11,-0.08,-2,-0.08,-2,36047007200,11220
72,2006,3,27,23,16,27,27,0.6875,11,0,0,0,0,36047007200,11220
72,2006,4,16,27,22,38,38,-0.272727,-6,-0.578947,-22,-0.578947,-22,36047007200,11220
72,2006,5,25,16,19,24,24,0.315789,6,0.041667,1,0.041667,1,36047007200,11220
72,2007,0,20,20,28,24,24,-0.285714,-8,-0.166667,-4,-0.166667,-4,36047007200,11220
72,2007,1,25,20,21,28,28,0.190476,4,-0.107143,-3,-0.107143,-3,36047007200,11220
72,2007,2,18,25,23,21,21,-0.217391,-5,-0.142857,-3,-0.142857,-3,36047007200,11220
72,2007,3,21,18,27,22,22,-0.222222,-6,-0.045455,-1,-0.045455,-1,36047007200,11220
72,2007,4,26,21,16,20,20,0.625,10,0.3,6,0.3,6,36047007200,11220
72,2007,5,19,26,25,30,30,-0.24,-6,-0.366667,-11,-0.366667,-11,36047007200,11220
72,2008,0,12,12,20,20,20,-0.4,-8,-0.4,-8,-0.4,-8,36047007200,11220
72,2008,1,21,12,25,23,23,-0.16,-4,-0.086957,-2,-0.086957,-2,36047007200,11220
72,2008,2,22,21,18,34,34,0.222222,4,-0.352941,-12,-0.352941,-12,36047007200,11220
72,2008,3,20,22,21,16,16,-0.047619,-1,0.25,4,0.25,4,36047007200,11220
72,2008,4,24,20,26,22,22,-0.076923,-2,0.090909,2,0.090909,2,36047007200,11220
72,2008,5,28,24,19,19,19,0.473684,9,0.473684,9,0.473684,9,36047007200,11220
72,2009,0,21,21,12,28,28,0.75,9,-0.25,-7,-0.25,-7,36047007200,11220
72,2009,1,19,21,21,21,21,-0.095238,-2,-0.095238,-2,-0.095238,-2,36047007200,11220
72,2009,2,24,19,22,23,23,0.090909,2,0.043478,1,0.043478,1,36047007200,11220
72,2009,3,19,24,20,27,27,-0.05,-1,-0.296296,-8,-0.296296,-8,36047007200,11220
72,2009,4,22,19,24,16,16,-0.083333,-2,0.375,6,0.375,6,36047007200,11220
72,2009,5,22,22,28,25,25,-0.214286,-6,-0.12,-3,-0.12,-3,36047007200,11220
72,2010,0,26,26,21,20,20,0.238095,5,0.3,6,0.3,6,36047007200,11220
72,2010,1,21,26,19,25,25,0.105263,2,-0.16,-4,-0.16,-4,36047007200,11220
72,2010,2,20,21,24,18,18,-0.166667,-4,0.111111,2,0.111111,2,36047007200,11220
72,2010,3,21,20,19,21,21,0.105263,2,0,0,0,0,36047007200,11220
72,2010,4,21,21,22,26,26,-0.045455,-1,-0.192308,-5,-0.192308,-5,36047007200,11220
72,2010,5,23,21,22,19,19,0.045455,1,0.210526,4,0.210526,4,36047007200,11220
74,2001,0,89,89,89,89,89,0,0,0,0,0,0,36047007400,11220
74,2001,1,105,89,105,105,105,0,0,0,0,0,0,36047007400,11220
74,2001,2,82,105,82,82,82,0,0,0,0,0,0,36047007400,11220
74,2001,3,81,82,81,81,81,0,0,0,0,0,0,36047007400,11220
74,2001,4,63,81,63,63,63,0,0,0,0,0,0,36047007400,11220
74,2001,5,75,63,75,75,75,0,0,0,0,0,0,36047007400,11220
74,2002,0,82,82,89,82,82,-0.078652,-7,0,0,0,0,36047007400,11220
74,2002,1,94,82,105,94,94,-0.104762,-11,0,0,0,0,36047007400,11220
74,2002,2,98,94,82,98,98,0.195122,16,0,0,0,0,36047007400,11220
74,2002,3,87,98,81,87,87,0.074074,6,0,0,0,0,36047007400,11220
74,2002,4,72,87,63,72,72,0.142857,9,0,0,0,0,36047007400,11220
74,2002,5,62,72,75,62,62,-0.173333,-13,0,0,0,0,36047007400,11220
74,2003,0,76,76,82,76,76,-0.073171,-6,0,0,0,0,36047007400,11220
74,2003,1,89,76,94,89,89,-0.053191,-5,0,0,0,0,36047007400,11220
74,2003,2,91,89,98,91,91,-0.071429,-7,0,0,0,0,36047007400,11220
74,2003,3,91,91,87,91,91,0.045977,4,0,0,0,0,36047007400,11220
74,2003,4,75,91,72,75,75,0.041667,3,0,0,0,0,36047007400,11220
74,2003,5,60,75,62,60,60,-0.032258,-2,0,0,0,0,36047007400,11220
74,2004,0,77,77,76,89,89,0.013158,1,-0.134831,-12,-0.134831,-12,36047007400,11220
74,2004,1,66,77,89,105,105,-0.258427,-23,-0.371429,-39,-0.371429,-39,36047007400,11220
74,2004,2,85,66,91,82,82,-0.065934,-6,0.036585,3,0.036585,3,36047007400,11220
74,2004,3,82,85,91,81,81,-0.098901,-9,0.012346,1,0.012346,1,36047007400,11220
74,2004,4,89,82,75,63,63,0.186667,14,0.412698,26,0.412698,26,36047007400,11220
74,2004,5,66,89,60,75,75,0.1,6,-0.12,-9,-0.12,-9,36047007400,11220
74,2005,0,89,89,77,82,82,0.155844,12,0.085366,7,0.085366,7,36047007400,11220
74,2005,1,86,89,66,94,94,0.30303,20,-0.085106,-8,-0.085106,-8,36047007400,11220
74,2005,2,73,86,85,98,98,-0.141176,-12,-0.255102,-25,-0.255102,-25,36047007400,11220
74,2005,3,80,73,82,87,87,-0.02439,-2,-0.08046,-7,-0.08046,-7,36047007400,11220
74,2005,4,72,80,89,72,72,-0.191011,-17,0,0,0,0,36047007400,11220
74,2005,5,86,72,66,62,62,0.30303,20,0.387097,24,0.387097,24,36047007400,11220
74,2006,0,87,87,89,76,76,-0.022472,-2,0.144737,11,0.144737,11,36047007400,11220
74,2006,1,83,87,86,89,89,-0.034884,-3,-0.067416,-6,-0.067416,-6,36047007400,11220
74,2006,2,81,83,73,91,91,0.109589,8,-0.10989,-10,-0.10989,-10,36047007400,11220
74,2006,3,68,81,80,91,91,-0.15,-12,-0.252747,-23,-0.252747,-23,36047007400,11220
74,2006,4,78,68,72,75,75,0.083333,6,0.04,3,0.04,3,36047007400,11220
74,2006,5,75,78,86,60,60,-0.127907,-11,0.25,15,0.25,15,36047007400,11220
74,2007,0,75,75,87,77,77,-0.137931,-12,-0.025974,-2,-0.025974,-2,36047007400,11220
74,2007,1,78,75,83,66,66,-0.060241,-5,0.181818,12,0.181818,12,36047007400,11220
74,2007,2,87,78,81,85,85,0.074074,6,0.023529,2,0.023529,2,36047007400,11220
74,2007,3,79,87,68,82,82,0.161765,11,-0.036585,-3,-0.036585,-3,36047007400,11220
74,2007,4,61,79,78,89,89,-0.217949,-17,-0.314607,-28,-0.314607,-28,36047007400,11220
74,2007,5,83,61,75,66,66,0.106667,8,0.257576,17,0.257576,17,36047007400,11220
74,2008,0,84,84,75,89,89,0.12,9,-0.05618,-5,-0.05618,-5,36047007400,11220
74,2008,1,76,84,78,86,86,-0.025641,-2,-0.116279,-10,-0.116279,-10,36047007400,11220
74,2008,2,74,76,87,73,73,-0.149425,-13,0.013699,1,0.013699,1,36047007400,11220
74,2008,3,84,74,79,80,80,0.063291,5,0.05,4,0.05,4,36047007400,11220
74,2008,4,73,84,61,72,72,0.196721,12,0.013889,1,0.013889,1,36047007400,11220
74,2008,5,64,73,83,86,86,-0.228916,-19,-0.255814,-22,-0.255814,-22,36047007400,11220
74,2009,0,95,95,84,87,87,0.130952,11,0.091954,8,0.091954,8,36047007400,11220
74,2009,1,110,95,76,83,83,0.447368,34,0.325301,27,0.325301,27,36047007400,11220
74,2009,2,81,110,74,81,81,0.094595,7,0,0,0,0,36047007400,11220
74,2009,3,84,81,84,68,68,0,0,0.235294,16,0.235294,16,36047007400,11220
74,2009,4,86,84,73,78,78,0.178082,13,0.102564,8,0.102564,8,36047007400,11220
74,2009,5,76,86,64,75,75,0.1875,12,0.013333,1,0.013333,1,36047007400,11220
74,2010,0,101,101,95,75,75,0.063158,6,0.346667,26,0.346667,26,36047007400,11220
74,2010,1,96,101,110,78,78,-0.127273,-14,0.230769,18,0.230769,18,36047007400,11220
74,2010,2,111,96,81,87,87,0.37037,30,0.275862,24,0.275862,24,36047007400,11220
74,2010,3,88,111,84,79,79,0.047619,4,0.113924,9,0.113924,9,36047007400,11220
74,2010,4,82,88,86,61,61,-0.046512,-4,0.344262,21,0.344262,21,36047007400,11220
74,2010,5,81,82,76,83,83,0.065789,5,-0.024096,-2,-0.024096,-2,36047007400,11220
75,2001,0,1,1,1,1,1,0,0,0,0,0,0,36047007500,11217
75,2002,1,1,0,0,1,1,1,1,0,0,0,0,36047007500,11217
76,2001,0,38,38,38,38,38,0,0,0,0,0,0,36047007600,11220
76,2001,1,46,38,46,46,46,0,0,0,0,0,0,36047007600,11220
76,2001,2,40,46,40,40,40,0,0,0,0,0,0,36047007600,11220
76,2001,3,34,40,34,34,34,0,0,0,0,0,0,36047007600,11220
76,2001,4,34,34,34,34,34,0,0,0,0,0,0,36047007600,11220
76,2001,5,40,34,40,40,40,0,0,0,0,0,0,36047007600,11220
76,2002,0,32,32,38,32,32,-0.157895,-6,0,0,0,0,36047007600,11220
76,2002,1,39,32,46,39,39,-0.152174,-7,0,0,0,0,36047007600,11220
76,2002,2,50,39,40,50,50,0.25,10,0,0,0,0,36047007600,11220
76,2002,3,44,50,34,44,44,0.294118,10,0,0,0,0,36047007600,11220
76,2002,4,30,44,34,30,30,-0.117647,-4,0,0,0,0,36047007600,11220
76,2002,5,25,30,40,25,25,-0.375,-15,0,0,0,0,36047007600,11220
76,2003,0,46,46,32,46,46,0.4375,14,0,0,0,0,36047007600,11220
76,2003,1,34,46,39,34,34,-0.128205,-5,0,0,0,0,36047007600,11220
76,2003,2,38,34,50,38,38,-0.24,-12,0,0,0,0,36047007600,11220
76,2003,3,47,38,44,47,47,0.068182,3,0,0,0,0,36047007600,11220
76,2003,4,36,47,30,36,36,0.2,6,0,0,0,0,36047007600,11220
76,2003,5,25,36,25,25,25,0,0,0,0,0,0,36047007600,11220
76,2004,0,32,32,46,38,38,-0.304348,-14,-0.157895,-6,-0.157895,-6,36047007600,11220
76,2004,1,44,32,34,46,46,0.294118,10,-0.043478,-2,-0.043478,-2,36047007600,11220
76,2004,2,36,44,38,40,40,-0.052632,-2,-0.1,-4,-0.1,-4,36047007600,11220
76,2004,3,42,36,47,34,34,-0.106383,-5,0.235294,8,0.235294,8,36047007600,11220
76,2004,4,43,42,36,34,34,0.194444,7,0.264706,9,0.264706,9,36047007600,11220
76,2004,5,32,43,25,40,40,0.28,7,-0.2,-8,-0.2,-8,36047007600,11220
76,2005,0,34,34,32,32,32,0.0625,2,0.0625,2,0.0625,2,36047007600,11220
76,2005,1,35,34,44,39,39,-0.204545,-9,-0.102564,-4,-0.102564,-4,36047007600,11220
76,2005,2,43,35,36,50,50,0.194444,7,-0.14,-7,-0.14,-7,36047007600,11220
76,2005,3,33,43,42,44,44,-0.214286,-9,-0.25,-11,-0.25,-11,36047007600,11220
76,2005,4,42,33,43,30,30,-0.023256,-1,0.4,12,0.4,12,36047007600,11220
76,2005,5,47,42,32,25,25,0.46875,15,0.88,22,0.88,22,36047007600,11220
76,2006,0,27,27,34,46,46,-0.205882,-7,-0.413043,-19,-0.413043,-19,36047007600,11220
76,2006,1,33,27,35,34,34,-0.057143,-2,-0.029412,-1,-0.029412,-1,36047007600,11220
76,2006,2,33,33,43,38,38,-0.232558,-10,-0.131579,-5,-0.131579,-5,36047007600,11220
76,2006,3,46,33,33,47,47,0.393939,13,-0.021277,-1,-0.021277,-1,36047007600,11220
76,2006,4,30,46,42,36,36,-0.285714,-12,-0.166667,-6,-0.166667,-6,36047007600,11220
76,2006,5,45,30,47,25,25,-0.042553,-2,0.8,20,0.8,20,36047007600,11220
76,2007,0,29,29,27,32,32,0.074074,2,-0.09375,-3,-0.09375,-3,36047007600,11220
76,2007,1,30,29,33,44,44,-0.090909,-3,-0.318182,-14,-0.318182,-14,36047007600,11220
76,2007,2,36,30,33,36,36,0.090909,3,0,0,0,0,36047007600,11220
76,2007,3,34,36,46,42,42,-0.26087,-12,-0.190476,-8,-0.190476,-8,36047007600,11220
76,2007,4,42,34,30,43,43,0.4,12,-0.023256,-1,-0.023256,-1,36047007600,11220
76,2007,5,30,42,45,32,32,-0.333333,-15,-0.0625,-2,-0.0625,-2,36047007600,11220
76,2008,0,29,29,29,34,34,0,0,-0.147059,-5,-0.147059,-5,36047007600,11220
76,2008,1,31,29,30,35,35,0.033333,1,-0.114286,-4,-0.114286,-4,36047007600,11220
76,2008,2,35,31,36,43,43,-0.027778,-1,-0.186047,-8,-0.186047,-8,36047007600,11220
76,2008,3,37,35,34,33,33,0.088235,3,0.121212,4,0.121212,4,36047007600,11220
76,2008,4,35,37,42,42,42,-0.166667,-7,-0.166667,-7,-0.166667,-7,36047007600,11220
76,2008,5,34,35,30,47,47,0.133333,4,-0.276596,-13,-0.276596,-13,36047007600,11220
76,2009,0,28,28,29,27,27,-0.034483,-1,0.037037,1,0.037037,1,36047007600,11220
76,2009,1,41,28,31,33,33,0.322581,10,0.242424,8,0.242424,8,36047007600,11220
76,2009,2,42,41,35,33,33,0.2,7,0.272727,9,0.272727,9,36047007600,11220
76,2009,3,28,42,37,46,46,-0.243243,-9,-0.391304,-18,-0.391304,-18,36047007600,11220
76,2009,4,27,28,35,30,30,-0.228571,-8,-0.1,-3,-0.1,-3,36047007600,11220
76,2009,5,33,27,34,45,45,-0.029412,-1,-0.266667,-12,-0.266667,-12,36047007600,11220
76,2010,0,36,36,28,29,29,0.285714,8,0.241379,7,0.241379,7,36047007600,11220
76,2010,1,24,36,41,30,30,-0.414634,-17,-0.2,-6,-0.2,-6,36047007600,11220
76,2010,2,42,24,42,36,36,0,0,0.166667,6,0.166667,6,36047007600,11220
76,2010,3,41,42,28,34,34,0.464286,13,0.205882,7,0.205882,7,36047007600,11220
76,2010,4,28,41,27,42,42,0.037037,1,-0.333333,-14,-0.333333,-14,36047007600,11220
76,2010,5,29,28,33,30,30,-0.121212,-4,-0.033333,-1,-0.033333,-1,36047007600,11220
78,2001,4,1,0,1,1,1,0,0,0,0,0,0,36047007800,11220
78,2002,5,1,0,0,1,1,1,1,0,0,0,0,36047007800,11220
80,2001,0,1,1,1,1,1,0,0,0,0,0,0,36047008000,11220
82,2001,1,1,0,1,1,1,0,0,0,0,0,0,36047008200,11220
82,2002,0,1,1,0,1,1,1,1,0,0,0,0,36047008200,11220
82,2002,2,1,0,0,1,1,1,1,0,0,0,0,36047008200,11220
82,2003,1,1,0,0,1,1,1,1,0,0,0,0,36047008200,11220
82,2003,3,1,0,0,1,1,1,1,0,0,0,0,36047008200,11220
82,2004,4,1,0,0,0,0,1,1,1,1,1,1,36047008200,11220
82,2005,5,1,0,0,0,0,1,1,1,1,1,1,36047008200,11220
90,2002,5,1,0,0,1,1,1,1,0,0,0,0,36047009000,11232
94,2001,0,12,12,12,12,12,0,0,0,0,0,0,36047009400,11220
94,2001,1,14,12,14,14,14,0,0,0,0,0,0,36047009400,11220
94,2001,2,3,14,3,3,3,0,0,0,0,0,0,36047009400,11220
94,2001,3,10,3,10,10,10,0,0,0,0,0,0,36047009400,11220
94,2001,4,8,10,8,8,8,0,0,0,0,0,0,36047009400,11220
94,2001,5,8,8,8,8,8,0,0,0,0,0,0,36047009400,11220
94,2002,0,10,10,12,10,10,-0.166667,-2,0,0,0,0,36047009400,11220
94,2002,1,10,10,14,10,10,-0.285714,-4,0,0,0,0,36047009400,11220
94,2002,2,9,10,3,9,9,2,6,0,0,0,0,36047009400,11220
94,2002,3,2,9,10,2,2,-0.8,-8,0,0,0,0,36047009400,11220
94,2002,4,11,2,8,11,11,0.375,3,0,0,0,0,36047009400,11220
94,2002,5,6,11,8,6,6,-0.25,-2,0,0,0,0,36047009400,11220
94,2003,0,6,6,10,6,6,-0.4,-4,0,0,0,0,36047009400,11220
94,2003,1,10,6,10,10,10,0,0,0,0,0,0,36047009400,11220
94,2003,2,10,10,9,10,10,0.111111,1,0,0,0,0,36047009400,11220
94,2003,3,9,10,2,9,9,3.5,7,0,0,0,0,36047009400,11220
94,2003,4,4,9,11,4,4,-0.636364,-7,0,0,0,0,36047009400,11220
94,2003,5,12,4,6,12,12,1,6,0,0,0,0,36047009400,11220
94,2004,0,13,13,6,12,12,1.166667,7,0.083333,1,0.083333,1,36047009400,11220
94,2004,1,7,13,10,14,14,-0.3,-3,-0.5,-7,-0.5,-7,36047009400,11220
94,2004,2,10,7,10,3,3,0,0,2.333333,7,2.333333,7,36047009400,11220
94,2004,3,8,10,9,10,10,-0.111111,-1,-0.2,-2,-0.2,-2,36047009400,11220
94,2004,4,8,8,4,8,8,1,4,0,0,0,0,36047009400,11220
94,2004,5,4,8,12,8,8,-0.666667,-8,-0.5,-4,-0.5,-4,36047009400,11220
94,2005,0,7,7,13,10,10,-0.461538,-6,-0.3,-3,-0.3,-3,36047009400,11220
94,2005,1,15,7,7,10,10,1.142857,8,0.5,5,0.5,5,36047009400,11220
94,2005,2,10,15,10,9,9,0,0,0.111111,1,0.111111,1,36047009400,11220
94,2005,3,11,10,8,2,2,0.375,3,4.5,9,4.5,9,36047009400,11220
94,2005,4,11,11,8,11,11,0.375,3,0,0,0,0,36047009400,11220
94,2005,5,9,11,4,6,6,1.25,5,0.5,3,0.5,3,36047009400,11220
94,2006,0,12,12,7,6,6,0.714286,5,1,6,1,6,36047009400,11220
94,2006,1,6,12,15,10,10,-0.6,-9,-0.4,-4,-0.4,-4,36047009400,11220
94,2006,2,14,6,10,10,10,0.4,4,0.4,4,0.4,4,36047009400,11220
94,2006,3,10,14,11,9,9,-0.090909,-1,0.111111,1,0.111111,1,36047009400,11220
94,2006,4,8,10,11,4,4,-0.272727,-3,1,4,1,4,36047009400,11220
94,2006,5,12,8,9,12,12,0.333333,3,0,0,0,0,36047009400,11220
94,2007,0,7,7,12,13,13,-0.416667,-5,-0.461538,-6,-0.461538,-6,36047009400,11220
94,2007,1,8,7,6,7,7,0.333333,2,0.142857,1,0.142857,1,36047009400,11220
94,2007,2,5,8,14,10,10,-0.642857,-9,-0.5,-5,-0.5,-5,36047009400,11220
94,2007,3,14,5,10,8,8,0.4,4,0.75,6,0.75,6,36047009400,11220
94,2007,4,9,14,8,8,8,0.125,1,0.125,1,0.125,1,36047009400,11220
94,2007,5,6,9,12,4,4,-0.5,-6,0.5,2,0.5,2,36047009400,11220
94,2008,0,6,6,7,7,7,-0.142857,-1,-0.142857,-1,-0.142857,-1,36047009400,11220
94,2008,1,8,6,8,15,15,0,0,-0.466667,-7,-0.466667,-7,36047009400,11220
94,2008,2,7,8,5,10,10,0.4,2,-0.3,-3,-0.3,-3,36047009400,11220
94,2008,3,7,7,14,11,11,-0.5,-7,-0.363636,-4,-0.363636,-4,36047009400,11220
94,2008,4,13,7,9,11,11,0.444444,4,0.181818,2,0.181818,2,36047009400,11220
94,2008,5,10,13,6,9,9,0.666667,4,0.111111,1,0.111111,1,36047009400,11220
94,2009,0,11,11,6,12,12,0.833333,5,-0.083333,-1,-0.083333,-1,36047009400,11220
94,2009,1,12,11,8,6,6,0.5,4,1,6,1,6,36047009400,11220
94,2009,2,9,12,7,14,14,0.285714,2,-0.357143,-5,-0.357143,-5,36047009400,11220
94,2009,3,12,9,7,10,10,0.714286,5,0.2,2,0.2,2,36047009400,11220
94,2009,4,7,12,13,8,8,-0.461538,-6,-0.125,-1,-0.125,-1,36047009400,11220
94,2009,5,9,7,10,12,12,-0.1,-1,-0.25,-3,-0.25,-3,36047009400,11220
94,2010,0,13,13,11,7,7,0.181818,2,0.857143,6,0.857143,6,36047009400,11220
94,2010,1,10,13,12,8,8,-0.166667,-2,0.25,2,0.25,2,36047009400,11220
94,2010,2,16,10,9,5,5,0.777778,7,2.2,11,2.2,11,36047009400,11220
94,2010,3,10,16,12,14,14,-0.166667,-2,-0.285714,-4,-0.285714,-4,36047009400,11220
94,2010,4,11,10,7,9,9,0.571429,4,0.222222,2,0.222222,2,36047009400,11220
94,2010,5,6,11,9,6,6,-0.333333,-3,0,0,0,0,36047009400,11220
96,2001,2,1,0,1,1,1,0,0,0,0,0,0,36047009600,11220
96,2001,4,1,0,1,1,1,0,0,0,0,0,0,36047009600,11220
96,2001,5,2,1,2,2,2,0,0,0,0,0,0,36047009600,11220
96,2002,3,2,0,0,2,2,1,2,0,0,0,0,36047009600,11220
96,2002,5,1,0,2,1,1,-0.5,-1,0,0,0,0,36047009600,11220
96,2003,4,2,0,0,2,2,1,2,0,0,0,0,36047009600,11220
96,2004,4,1,0,2,1,1,-0.5,-1,0,0,0,0,36047009600,11220
96,2004,5,1,1,2,2,2,-0.5,-1,-0.5,-1,-0.5,-1,36047009600,11220
96,2005,5,1,0,1,1,1,0,0,0,0,0,0,36047009600,11220
98,2001,1,1,0,1,1,1,0,0,0,0,0,0,36047009800,11220
98,2001,2,3,1,3,3,3,0,0,0,0,0,0,36047009800,11220
98,2001,3,1,3,1,1,1,0,0,0,0,0,0,36047009800,11220
98,2002,2,1,0,3,1,1,-0.666667,-2,0,0,0,0,36047009800,11220
98,2002,3,3,1,1,3,3,2,2,0,0,0,0,36047009800,11220
98,2002,4,1,3,0,1,1,1,1,0,0,0,0,36047009800,11220
98,2003,3,2,0,3,2,2,-0.333333,-1,0,0,0,0,36047009800,11220
98,2003,4,2,2,1,2,2,1,1,0,0,0,0,36047009800,11220
98,2003,5,1,2,0,1,1,1,1,0,0,0,0,36047009800,11220
98,2004,4,2,0,2,0,0,0,0,1,2,1,2,36047009800,11220
98,2004,5,1,2,1,0,0,0,0,1,1,1,1,36047009800,11220
98,2005,5,2,0,1,0,0,1,1,1,2,1,2,36047009800,11220
100,2001,0,28,28,28,28,28,0,0,0,0,0,0,36047010000,11220
100,2001,1,31,28,31,31,31,0,0,0,0,0,0,36047010000,11220
100,2001,2,27,31,27,27,27,0,0,0,0,0,0,36047010000,11220
100,2001,3,24,27,24,24,24,0,0,0,0,0,0,36047010000,11220
100,2001,4,28,24,28,28,28,0,0,0,0,0,0,36047010000,11220
100,2001,5,23,28,23,23,23,0,0,0,0,0,0,36047010000,11220
100,2002,0,33,33,28,33,33,0.178571,5,0,0,0,0,36047010000,11220
100,2002,1,29,33,31,29,29,-0.064516,-2,0,0,0,0,36047010000,11220
100,2002,2,34,29,27,34,34,0.259259,7,0,0,0,0,36047010000,11220
100,2002,3,23,34,24,23,23,-0.041667,-1,0,0,0,0,36047010000,11220
100,2002,4,25,23,28,25,25,-0.107143,-3,0,0,0,0,36047010000,11220
100,2002,5,24,25,23,24,24,0.043478,1,0,0,0,0,36047010000,11220
100,2003,0,21,21,33,21,21,-0.363636,-12,0,0,0,0,36047010000,11220
100,2003,1,32,21,29,32,32,0.103448,3,0,0,0,0,36047010000,11220
100,2003,2,37,32,34,37,37,0.088235,3,0,0,0,0,36047010000,11220
100,2003,3,26,37,23,26,26,0.130435,3,0,0,0,0,36047010000,11220
100,2003,4,22,26,25,22,22,-0.12,-3,0,0,0,0,36047010000,11220
100,2003,5,26,22,24,26,26,0.083333,2,0,0,0,0,36047010000,11220
100,2004,0,21,21,21,28,28,0,0,-0.25,-7,-0.25,-7,36047010000,11220
100,2004,1,24,21,32,31,31,-0.25,-8,-0.225806,-7,-0.225806,-7,36047010000,11220
100,2004,2,29,24,37,27,27,-0.216216,-8,0.074074,2,0.074074,2,36047010000,11220
100,2004,3,25,29,26,24,24,-0.038462,-1,0.041667,1,0.041667,1,36047010000,11220
100,2004,4,24,25,22,28,28,0.090909,2,-0.142857,-4,-0.142857,-4,36047010000,11220
100,2004,5,17,24,26,23,23,-0.346154,-9,-0.26087,-6,-0.26087,-6,36047010000,11220
100,2005,0,26,26,21,33,33,0.238095,5,-0.212121,-7,-0.212121,-7,36047010000,11220
100,2005,1,22,26,24,29,29,-0.083333,-2,-0.241379,-7,-0.241379,-7,36047010000,11220
100,2005,2,24,22,29,34,34,-0.172414,-5,-0.294118,-10,-0.294118,-10,36047010000,11220
100,2005,3,23,24,25,23,23,-0.08,-2,0,0,0,0,36047010000,11220
100,2005,4,18,23,24,25,25,-0.25,-6,-0.28,-7,-0.28,-7,36047010000,11220
100,2005,5,20,18,17,24,24,0.176471,3,-0.166667,-4,-0.166667,-4,36047010000,11220
100,2006,0,24,24,26,21,21,-0.076923,-2,0.142857,3,0.142857,3,36047010000,11220
100,2006,1,27,24,22,32,32,0.227273,5,-0.15625,-5,-0.15625,-5,36047010000,11220
100,2006,2,17,27,24,37,37,-0.291667,-7,-0.540541,-20,-0.540541,-20,36047010000,11220
100,2006,3,24,17,23,26,26,0.043478,1,-0.076923,-2,-0.076923,-2,36047010000,11220
100,2006,4,24,24,18,22,22,0.333333,6,0.090909,2,0.090909,2,36047010000,11220
100,2006,5,15,24,20,26,26,-0.25,-5,-0.423077,-11,-0.423077,-11,36047010000,11220
100,2007,0,9,9,24,21,21,-0.625,-15,-0.571429,-12,-0.571429,-12,36047010000,11220
100,2007,1,23,9,27,24,24,-0.148148,-4,-0.041667,-1,-0.041667,-1,36047010000,11220
100,2007,2,25,23,17,29,29,0.470588,8,-0.137931,-4,-0.137931,-4,36047010000,11220
100,2007,3,17,25,24,25,25,-0.291667,-7,-0.32,-8,-0.32,-8,36047010000,11220
100,2007,4,16,17,24,24,24,-0.333333,-8,-0.333333,-8,-0.333333,-8,36047010000,11220
100,2007,5,23,16,15,17,17,0.533333,8,0.352941,6,0.352941,6,36047010000,11220
100,2008,0,27,27,9,26,26,2,18,0.038462,1,0.038462,1,36047010000,11220
100,2008,1,17,27,23,22,22,-0.26087,-6,-0.227273,-5,-0.227273,-5,36047010000,11220
100,2008,2,22,17,25,24,24,-0.12,-3,-0.083333,-2,-0.083333,-2,36047010000,11220
100,2008,3,24,22,17,23,23,0.411765,7,0.043478,1,0.043478,1,36047010000,11220
100,2008,4,16,24,16,18,18,0,0,-0.111111,-2,-0.111111,-2,36047010000,11220
100,2008,5,15,16,23,20,20,-0.347826,-8,-0.25,-5,-0.25,-5,36047010000,11220
100,2009,0,32,32,27,24,24,0.185185,5,0.333333,8,0.333333,8,36047010000,11220
100,2009,1,35,32,17,27,27,1.058824,18,0.296296,8,0.296296,8,36047010000,11220
100,2009,2,21,35,22,17,17,-0.045455,-1,0.235294,4,0.235294,4,36047010000,11220
100,2009,3,27,21,24,24,24,0.125,3,0.125,3,0.125,3,36047010000,11220
100,2009,4,25,27,16,24,24,0.5625,9,0.041667,1,0.041667,1,36047010000,11220
100,2009,5,21,25,15,15,15,0.4,6,0.4,6,0.4,6,36047010000,11220
100,2010,0,34,34,32,9,9,0.0625,2,2.777778,25,2.777778,25,36047010000,11220
100,2010,1,36,34,35,23,23,0.028571,1,0.565217,13,0.565217,13,36047010000,11220
100,2010,2,38,36,21,25,25,0.809524,17,0.52,13,0.52,13,36047010000,11220
100,2010,3,27,38,27,17,17,0,0,0.588235,10,0.588235,10,36047010000,11220
100,2010,4,24,27,25,16,16,-0.04,-1,0.5,8,0.5,8,36047010000,11220
100,2010,5,36,24,21,23,23,0.714286,15,0.565217,13,0.565217,13,36047010000,11220
102,2001,0,37,37,37,37,37,0,0,0,0,0,0,36047010200,11220
102,2001,1,53,37,53,53,53,0,0,0,0,0,0,36047010200,11220
102,2001,2,60,53,60,60,60,0,0,0,0,0,0,36047010200,11220
102,2001,3,60,60,60,60,60,0,0,0,0,0,0,36047010200,11220
102,2001,4,44,60,44,44,44,0,0,0,0,0,0,36047010200,11220
102,2001,5,51,44,51,51,51,0,0,0,0,0,0,36047010200,11220
102,2002,0,34,34,37,34,34,-0.081081,-3,0,0,0,0,36047010200,11220
102,2002,1,47,34,53,47,47,-0.113208,-6,0,0,0,0,36047010200,11220
102,2002,2,45,47,60,45,45,-0.25,-15,0,0,0,0,36047010200,11220
102,2002,3,59,45,60,59,59,-0.016667,-1,0,0,0,0,36047010200,11220
102,2002,4,59,59,44,59,59,0.340909,15,0,0,0,0,36047010200,11220
102,2002,5,39,59,51,39,39,-0.235294,-12,0,0,0,0,36047010200,11220
102,2003,0,56,56,34,56,56,0.647059,22,0,0,0,0,36047010200,11220
102,2003,1,39,56,47,39,39,-0.170213,-8,0,0,0,0,36047010200,11220
102,2003,2,51,39,45,51,51,0.133333,6,0,0,0,0,36047010200,11220
102,2003,3,39,51,59,39,39,-0.338983,-20,0,0,0,0,36047010200,11220
102,2003,4,65,39,59,65,65,0.101695,6,0,0,0,0,36047010200,11220
102,2003,5,61,65,39,61,61,0.564103,22,0,0,0,0,36047010200,11220
102,2004,0,54,54,56,37,37,-0.035714,-2,0.459459,17,0.459459,17,36047010200,11220
102,2004,1,60,54,39,53,53,0.538462,21,0.132075,7,0.132075,7,36047010200,11220
102,2004,2,38,60,51,60,60,-0.254902,-13,-0.366667,-22,-0.366667,-22,36047010200,11220
102,2004,3,42,38,39,60,60,0.076923,3,-0.3,-18,-0.3,-18,36047010200,11220
102,2004,4,42,42,65,44,44,-0.353846,-23,-0.045455,-2,-0.045455,-2,36047010200,11220
102,2004,5,63,42,61,51,51,0.032787,2,0.235294,12,0.235294,12,36047010200,11220
102,2005,0,53,53,54,34,34,-0.018519,-1,0.558824,19,0.558824,19,36047010200,11220
102,2005,1,49,53,60,47,47,-0.183333,-11,0.042553,2,0.042553,2,36047010200,11220
102,2005,2,57,49,38,45,45,0.5,19,0.266667,12,0.266667,12,36047010200,11220
102,2005,3,47,57,42,59,59,0.119048,5,-0.20339,-12,-0.20339,-12,36047010200,11220
102,2005,4,36,47,42,59,59,-0.142857,-6,-0.389831,-23,-0.389831,-23,36047010200,11220
102,2005,5,44,36,63,39,39,-0.301587,-19,0.128205,5,0.128205,5,36047010200,11220
102,2006,0,46,46,53,56,56,-0.132075,-7,-0.178571,-10,-0.178571,-10,36047010200,11220
102,2006,1,61,46,49,39,39,0.244898,12,0.564103,22,0.564103,22,36047010200,11220
102,2006,2,51,61,57,51,51,-0.105263,-6,0,0,0,0,36047010200,11220
102,2006,3,59,51,47,39,39,0.255319,12,0.512821,20,0.512821,20,36047010200,11220
102,2006,4,34,59,36,65,65,-0.055556,-2,-0.476923,-31,-0.476923,-31,36047010200,11220
102,2006,5,38,34,44,61,61,-0.136364,-6,-0.377049,-23,-0.377049,-23,36047010200,11220
102,2007,0,41,41,46,54,54,-0.108696,-5,-0.240741,-13,-0.240741,-13,36047010200,11220
102,2007,1,46,41,61,60,60,-0.245902,-15,-0.233333,-14,-0.233333,-14,36047010200,11220
102,2007,2,56,46,51,38,38,0.098039,5,0.473684,18,0.473684,18,36047010200,11220
102,2007,3,53,56,59,42,42,-0.101695,-6,0.261905,11,0.261905,11,36047010200,11220
102,2007,4,50,53,34,42,42,0.470588,16,0.190476,8,0.190476,8,36047010200,11220
102,2007,5,32,50,38,63,63,-0.157895,-6,-0.492063,-31,-0.492063,-31,36047010200,11220
102,2008,0,44,44,41,53,53,0.073171,3,-0.169811,-9,-0.169811,-9,36047010200,11220
102,2008,1,50,44,46,49,49,0.086957,4,0.020408,1,0.020408,1,36047010200,11220
102,2008,2,47,50,56,57,57,-0.160714,-9,-0.175439,-10,-0.175439,-10,36047010200,11220
102,2008,3,52,47,53,47,47,-0.018868,-1,0.106383,5,0.106383,5,36047010200,11220
102,2008,4,59,52,50,36,36,0.18,9,0.638889,23,0.638889,23,36047010200,11220
102,2008,5,53,59,32,44,44,0.65625,21,0.204545,9,0.204545,9,36047010200,11220
102,2009,0,78,78,44,46,46,0.772727,34,0.695652,32,0.695652,32,36047010200,11220
102,2009,1,66,78,50,61,61,0.32,16,0.081967,5,0.081967,5,36047010200,11220
102,2009,2,61,66,47,51,51,0.297872,14,0.196078,10,0.196078,10,36047010200,11220
102,2009,3,67,61,52,59,59,0.288462,15,0.135593,8,0.135593,8,36047010200,11220
102,2009,4,58,67,59,34,34,-0.016949,-1,0.705882,24,0.705882,24,36047010200,11220
102,2009,5,64,58,53,38,38,0.207547,11,0.684211,26,0.684211,26,36047010200,11220
102,2010,0,95,95,78,41,41,0.217949,17,1.317073,54,1.317073,54,36047010200,11220
102,2010,1,83,95,66,46,46,0.257576,17,0.804348,37,0.804348,37,36047010200,11220
102,2010,2,78,83,61,56,56,0.278689,17,0.392857,22,0.392857,22,36047010200,11220
102,2010,3,64,78,67,53,53,-0.044776,-3,0.207547,11,0.207547,11,36047010200,11220
102,2010,4,69,64,58,50,50,0.189655,11,0.38,19,0.38,19,36047010200,11220
102,2010,5,65,69,64,32,32,0.015625,1,1.03125,33,1.03125,33,36047010200,11220
104,2001,0,67,67,67,67,67,0,0,0,0,0,0,36047010400,11220
104,2001,1,79,67,79,79,79,0,0,0,0,0,0,36047010400,11220
104,2001,2,77,79,77,77,77,0,0,0,0,0,0,36047010400,11220
104,2001,3,53,77,53,53,53,0,0,0,0,0,0,36047010400,11220
104,2001,4,63,53,63,63,63,0,0,0,0,0,0,36047010400,11220
104,2001,5,55,63,55,55,55,0,0,0,0,0,0,36047010400,11220
104,2002,0,86,86,67,86,86,0.283582,19,0,0,0,0,36047010400,11220
104,2002,1,76,86,79,76,76,-0.037975,-3,0,0,0,0,36047010400,11220
104,2002,2,71,76,77,71,71,-0.077922,-6,0,0,0,0,36047010400,11220
104,2002,3,68,71,53,68,68,0.283019,15,0,0,0,0,36047010400,11220
104,2002,4,53,68,63,53,53,-0.15873,-10,0,0,0,0,36047010400,11220
104,2002,5,65,53,55,65,65,0.181818,10,0,0,0,0,36047010400,11220
104,2003,0,73,73,86,73,73,-0.151163,-13,0,0,0,0,36047010400,11220
104,2003,1,83,73,76,83,83,0.092105,7,0,0,0,0,36047010400,11220
104,2003,2,67,83,71,67,67,-0.056338,-4,0,0,0,0,36047010400,11220
104,2003,3,67,67,68,67,67,-0.014706,-1,0,0,0,0,36047010400,11220
104,2003,4,65,67,53,65,65,0.226415,12,0,0,0,0,36047010400,11220
104,2003,5,63,65,65,63,63,-0.030769,-2,0,0,0,0,36047010400,11220
104,2004,0,67,67,73,67,67,-0.082192,-6,0,0,0,0,36047010400,11220
104,2004,1,79,67,83,79,79,-0.048193,-4,0,0,0,0,36047010400,11220
104,2004,2,81,79,67,77,77,0.208955,14,0.051948,4,0.051948,4,36047010400,11220
104,2004,3,66,81,67,53,53,-0.014925,-1,0.245283,13,0.245283,13,36047010400,11220
104,2004,4,60,66,65,63,63,-0.076923,-5,-0.047619,-3,-0.047619,-3,36047010400,11220
104,2004,5,65,60,63,55,55,0.031746,2,0.181818,10,0.181818,10,36047010400,11220
104,2005,0,78,78,67,86,86,0.164179,11,-0.093023,-8,-0.093023,-8,36047010400,11220
104,2005,1,73,78,79,76,76,-0.075949,-6,-0.039474,-3,-0.039474,-3,36047010400,11220
104,2005,2,74,73,81,71,71,-0.08642,-7,0.042254,3,0.042254,3,36047010400,11220
104,2005,3,77,74,66,68,68,0.166667,11,0.132353,9,0.132353,9,36047010400,11220
104,2005,4,65,77,60,53,53,0.083333,5,0.226415,12,0.226415,12,36047010400,11220
104,2005,5,54,65,65,65,65,-0.169231,-11,-0.169231,-11,-0.169231,-11,36047010400,11220
104,2006,0,69,69,78,73,73,-0.115385,-9,-0.054795,-4,-0.054795,-4,36047010400,11220
104,2006,1,72,69,73,83,83,-0.013699,-1,-0.13253,-11,-0.13253,-11,36047010400,11220
104,2006,2,67,72,74,67,67,-0.094595,-7,0,0,0,0,36047010400,11220
104,2006,3,74,67,77,67,67,-0.038961,-3,0.104478,7,0.104478,7,36047010400,11220
104,2006,4,70,74,65,65,65,0.076923,5,0.076923,5,0.076923,5,36047010400,11220
104,2006,5,63,70,54,63,63,0.166667,9,0,0,0,0,36047010400,11220
104,2007,0,61,61,69,67,67,-0.115942,-8,-0.089552,-6,-0.089552,-6,36047010400,11220
104,2007,1,69,61,72,79,79,-0.041667,-3,-0.126582,-10,-0.126582,-10,36047010400,11220
104,2007,2,71,69,67,81,81,0.059701,4,-0.123457,-10,-0.123457,-10,36047010400,11220
104,2007,3,67,71,74,66,66,-0.094595,-7,0.015152,1,0.015152,1,36047010400,11220
104,2007,4,65,67,70,60,60,-0.071429,-5,0.083333,5,0.083333,5,36047010400,11220
104,2007,5,71,65,63,65,65,0.126984,8,0.092308,6,0.092308,6,36047010400,11220
104,2008,0,77,77,61,78,78,0.262295,16,-0.012821,-1,-0.012821,-1,36047010400,11220
104,2008,1,71,77,69,73,73,0.028986,2,-0.027397,-2,-0.027397,-2,36047010400,11220
104,2008,2,68,71,71,74,74,-0.042254,-3,-0.081081,-6,-0.081081,-6,36047010400,11220
104,2008,3,68,68,67,77,77,0.014925,1,-0.116883,-9,-0.116883,-9,36047010400,11220
104,2008,4,69,68,65,65,65,0.061538,4,0.061538,4,0.061538,4,36047010400,11220
104,2008,5,65,69,71,54,54,-0.084507,-6,0.203704,11,0.203704,11,36047010400,11220
104,2009,0,92,92,77,69,69,0.194805,15,0.333333,23,0.333333,23,36047010400,11220
104,2009,1,113,92,71,72,72,0.591549,42,0.569444,41,0.569444,41,36047010400,11220
104,2009,2,91,113,68,67,67,0.338235,23,0.358209,24,0.358209,24,36047010400,11220
104,2009,3,75,91,68,74,74,0.102941,7,0.013514,1,0.013514,1,36047010400,11220
104,2009,4,78,75,69,70,70,0.130435,9,0.114286,8,0.114286,8,36047010400,11220
104,2009,5,62,78,65,63,63,-0.046154,-3,-0.015873,-1,-0.015873,-1,36047010400,11220
104,2010,0,107,107,92,61,61,0.163043,15,0.754098,46,0.754098,46,36047010400,11220
104,2010,1,108,107,113,69,69,-0.044248,-5,0.565217,39,0.565217,39,36047010400,11220
104,2010,2,121,108,91,71,71,0.32967,30,0.704225,50,0.704225,50,36047010400,11220
104,2010,3,104,121,75,67,67,0.386667,29,0.552239,37,0.552239,37,36047010400,11220
104,2010,4,82,104,78,65,65,0.051282,4,0.261538,17,0.261538,17,36047010400,11220
104,2010,5,71,82,62,71,71,0.145161,9,0,0,0,0,36047010400,11220
106,2001,0,43,43,43,43,43,0,0,0,0,0,0,36047010600,11220
106,2001,1,55,43,55,55,55,0,0,0,0,0,0,36047010600,11220
106,2001,2,48,55,48,48,48,0,0,0,0,0,0,36047010600,11220
106,2001,3,51,48,51,51,51,0,0,0,0,0,0,36047010600,11220
106,2001,4,43,51,43,43,43,0,0,0,0,0,0,36047010600,11220
106,2001,5,46,43,46,46,46,0,0,0,0,0,0,36047010600,11220
106,2002,0,37,37,43,37,37,-0.139535,-6,0,0,0,0,36047010600,11220
106,2002,1,47,37,55,47,47,-0.145455,-8,0,0,0,0,36047010600,11220
106,2002,2,50,47,48,50,50,0.041667,2,0,0,0,0,36047010600,11220
106,2002,3,56,50,51,56,56,0.098039,5,0,0,0,0,36047010600,11220
106,2002,4,52,56,43,52,52,0.209302,9,0,0,0,0,36047010600,11220
106,2002,5,44,52,46,44,44,-0.043478,-2,0,0,0,0,36047010600,11220
106,2003,0,41,41,37,41,41,0.108108,4,0,0,0,0,36047010600,11220
106,2003,1,47,41,47,47,47,0,0,0,0,0,0,36047010600,11220
106,2003,2,43,47,50,43,43,-0.14,-7,0,0,0,0,36047010600,11220
106,2003,3,47,43,56,47,47,-0.160714,-9,0,0,0,0,36047010600,11220
106,2003,4,53,47,52,53,53,0.019231,1,0,0,0,0,36047010600,11220
106,2003,5,45,53,44,45,45,0.022727,1,0,0,0,0,36047010600,11220
106,2004,0,54,54,41,43,43,0.317073,13,0.255814,11,0.255814,11,36047010600,11220
106,2004,1,39,54,47,55,55,-0.170213,-8,-0.290909,-16,-0.290909,-16,36047010600,11220
106,2004,2,40,39,43,48,48,-0.069767,-3,-0.166667,-8,-0.166667,-8,36047010600,11220
106,2004,3,40,40,47,51,51,-0.148936,-7,-0.215686,-11,-0.215686,-11,36047010600,11220
106,2004,4,45,40,53,43,43,-0.150943,-8,0.046512,2,0.046512,2,36047010600,11220
106,2004,5,48,45,45,46,46,0.066667,3,0.043478,2,0.043478,2,36047010600,11220
106,2005,0,39,39,54,37,37,-0.277778,-15,0.054054,2,0.054054,2,36047010600,11220
106,2005,1,50,39,39,47,47,0.282051,11,0.06383,3,0.06383,3,36047010600,11220
106,2005,2,34,50,40,50,50,-0.15,-6,-0.32,-16,-0.32,-16,36047010600,11220
106,2005,3,40,34,40,56,56,0,0,-0.285714,-16,-0.285714,-16,36047010600,11220
106,2005,4,37,40,45,52,52,-0.177778,-8,-0.288462,-15,-0.288462,-15,36047010600,11220
106,2005,5,40,37,48,44,44,-0.166667,-8,-0.090909,-4,-0.090909,-4,36047010600,11220
106,2006,0,35,35,39,41,41,-0.102564,-4,-0.146341,-6,-0.146341,-6,36047010600,11220
106,2006,1,46,35,50,47,47,-0.08,-4,-0.021277,-1,-0.021277,-1,36047010600,11220
106,2006,2,55,46,34,43,43,0.617647,21,0.27907,12,0.27907,12,36047010600,11220
106,2006,3,40,55,40,47,47,0,0,-0.148936,-7,-0.148936,-7,36047010600,11220
106,2006,4,44,40,37,53,53,0.189189,7,-0.169811,-9,-0.169811,-9,36047010600,11220
106,2006,5,28,44,40,45,45,-0.3,-12,-0.377778,-17,-0.377778,-17,36047010600,11220
106,2007,0,37,37,35,54,54,0.057143,2,-0.314815,-17,-0.314815,-17,36047010600,11220
106,2007,1,36,37,46,39,39,-0.217391,-10,-0.076923,-3,-0.076923,-3,36047010600,11220
106,2007,2,42,36,55,40,40,-0.236364,-13,0.05,2,0.05,2,36047010600,11220
106,2007,3,52,42,40,40,40,0.3,12,0.3,12,0.3,12,36047010600,11220
106,2007,4,43,52,44,45,45,-0.022727,-1,-0.044444,-2,-0.044444,-2,36047010600,11220
106,2007,5,45,43,28,48,48,0.607143,17,-0.0625,-3,-0.0625,-3,36047010600,11220
106,2008,0,37,37,37,39,39,0,0,-0.051282,-2,-0.051282,-2,36047010600,11220
106,2008,1,42,37,36,50,50,0.166667,6,-0.16,-8,-0.16,-8,36047010600,11220
106,2008,2,30,42,42,34,34,-0.285714,-12,-0.117647,-4,-0.117647,-4,36047010600,11220
106,2008,3,38,30,52,40,40,-0.269231,-14,-0.05,-2,-0.05,-2,36047010600,11220
106,2008,4,53,38,43,37,37,0.232558,10,0.432432,16,0.432432,16,36047010600,11220
106,2008,5,38,53,45,40,40,-0.155556,-7,-0.05,-2,-0.05,-2,36047010600,11220
106,2009,0,43,43,37,35,35,0.162162,6,0.228571,8,0.228571,8,36047010600,11220
106,2009,1,47,43,42,46,46,0.119048,5,0.021739,1,0.021739,1,36047010600,11220
106,2009,2,56,47,30,55,55,0.866667,26,0.018182,1,0.018182,1,36047010600,11220
106,2009,3,35,56,38,40,40,-0.078947,-3,-0.125,-5,-0.125,-5,36047010600,11220
106,2009,4,50,35,53,44,44,-0.056604,-3,0.136364,6,0.136364,6,36047010600,11220
106,2009,5,50,50,38,28,28,0.315789,12,0.785714,22,0.785714,22,36047010600,11220
106,2010,0,69,69,43,37,37,0.604651,26,0.864865,32,0.864865,32,36047010600,11220
106,2010,1,60,69,47,36,36,0.276596,13,0.666667,24,0.666667,24,36047010600,11220
106,2010,2,56,60,56,42,42,0,0,0.333333,14,0.333333,14,36047010600,11220
106,2010,3,69,56,35,52,52,0.971429,34,0.326923,17,0.326923,17,36047010600,11220
106,2010,4,41,69,50,43,43,-0.18,-9,-0.046512,-2,-0.046512,-2,36047010600,11220
106,2010,5,56,41,50,45,45,0.12,6,0.244444,11,0.244444,11,36047010600,11220
108,2001,0,44,44,44,44,44,0,0,0,0,0,0,36047010800,11220
108,2001,1,36,44,36,36,36,0,0,0,0,0,0,36047010800,11220
108,2001,2,32,36,32,32,32,0,0,0,0,0,0,36047010800,11220
108,2001,3,28,32,28,28,28,0,0,0,0,0,0,36047010800,11220
108,2001,4,27,28,27,27,27,0,0,0,0,0,0,36047010800,11220
108,2001,5,36,27,36,36,36,0,0,0,0,0,0,36047010800,11220
108,2002,0,30,30,44,30,30,-0.318182,-14,0,0,0,0,36047010800,11220
108,2002,1,39,30,36,39,39,0.083333,3,0,0,0,0,36047010800,11220
108,2002,2,32,39,32,32,32,0,0,0,0,0,0,36047010800,11220
108,2002,3,29,32,28,29,29,0.035714,1,0,0,0,0,36047010800,11220
108,2002,4,30,29,27,30,30,0.111111,3,0,0,0,0,36047010800,11220
108,2002,5,23,30,36,23,23,-0.361111,-13,0,0,0,0,36047010800,11220
108,2003,0,28,28,30,28,28,-0.066667,-2,0,0,0,0,36047010800,11220
108,2003,1,30,28,39,30,30,-0.230769,-9,0,0,0,0,36047010800,11220
108,2003,2,39,30,32,39,39,0.21875,7,0,0,0,0,36047010800,11220
108,2003,3,29,39,29,29,29,0,0,0,0,0,0,36047010800,11220
108,2003,4,20,29,30,20,20,-0.333333,-10,0,0,0,0,36047010800,11220
108,2003,5,27,20,23,27,27,0.173913,4,0,0,0,0,36047010800,11220
108,2004,0,34,34,28,44,44,0.214286,6,-0.227273,-10,-0.227273,-10,36047010800,11220
108,2004,1,30,34,30,36,36,0,0,-0.166667,-6,-0.166667,-6,36047010800,11220
108,2004,2,28,30,39,32,32,-0.282051,-11,-0.125,-4,-0.125,-4,36047010800,11220
108,2004,3,39,28,29,28,28,0.344828,10,0.392857,11,0.392857,11,36047010800,11220
108,2004,4,25,39,20,27,27,0.25,5,-0.074074,-2,-0.074074,-2,36047010800,11220
108,2004,5,19,25,27,36,36,-0.296296,-8,-0.472222,-17,-0.472222,-17,36047010800,11220
108,2005,0,30,30,34,30,30,-0.117647,-4,0,0,0,0,36047010800,11220
108,2005,1,29,30,30,39,39,-0.033333,-1,-0.25641,-10,-0.25641,-10,36047010800,11220
108,2005,2,28,29,28,32,32,0,0,-0.125,-4,-0.125,-4,36047010800,11220
108,2005,3,34,28,39,29,29,-0.128205,-5,0.172414,5,0.172414,5,36047010800,11220
108,2005,4,34,34,25,30,30,0.36,9,0.133333,4,0.133333,4,36047010800,11220
108,2005,5,23,34,19,23,23,0.210526,4,0,0,0,0,36047010800,11220
108,2006,0,43,43,30,28,28,0.433333,13,0.535714,15,0.535714,15,36047010800,11220
108,2006,1,43,43,29,30,30,0.482759,14,0.433333,13,0.433333,13,36047010800,11220
108,2006,2,34,43,28,39,39,0.214286,6,-0.128205,-5,-0.128205,-5,36047010800,11220
108,2006,3,30,34,34,29,29,-0.117647,-4,0.034483,1,0.034483,1,36047010800,11220
108,2006,4,37,30,34,20,20,0.088235,3,0.85,17,0.85,17,36047010800,11220
108,2006,5,36,37,23,27,27,0.565217,13,0.333333,9,0.333333,9,36047010800,11220
108,2007,0,33,33,43,34,34,-0.232558,-10,-0.029412,-1,-0.029412,-1,36047010800,11220
108,2007,1,48,33,43,30,30,0.116279,5,0.6,18,0.6,18,36047010800,11220
108,2007,2,35,48,34,28,28,0.029412,1,0.25,7,0.25,7,36047010800,11220
108,2007,3,31,35,30,39,39,0.033333,1,-0.205128,-8,-0.205128,-8,36047010800,11220
108,2007,4,31,31,37,25,25,-0.162162,-6,0.24,6,0.24,6,36047010800,11220
108,2007,5,37,31,36,19,19,0.027778,1,0.947368,18,0.947368,18,36047010800,11220
108,2008,0,38,38,33,30,30,0.151515,5,0.266667,8,0.266667,8,36047010800,11220
108,2008,1,39,38,48,29,29,-0.1875,-9,0.344828,10,0.344828,10,36047010800,11220
108,2008,2,52,39,35,28,28,0.485714,17,0.857143,24,0.857143,24,36047010800,11220
108,2008,3,30,52,31,34,34,-0.032258,-1,-0.117647,-4,-0.117647,-4,36047010800,11220
108,2008,4,37,30,31,34,34,0.193548,6,0.088235,3,0.088235,3,36047010800,11220
108,2008,5,28,37,37,23,23,-0.243243,-9,0.217391,5,0.217391,5,36047010800,11220
108,2009,0,44,44,38,43,43,0.157895,6,0.023256,1,0.023256,1,36047010800,11220
108,2009,1,53,44,39,43,43,0.358974,14,0.232558,10,0.232558,10,36047010800,11220
108,2009,2,54,53,52,34,34,0.038462,2,0.588235,20,0.588235,20,36047010800,11220
108,2009,3,52,54,30,30,30,0.733333,22,0.733333,22,0.733333,22,36047010800,11220
108,2009,4,36,52,37,37,37,-0.027027,-1,-0.027027,-1,-0.027027,-1,36047010800,11220
108,2009,5,33,36,28,36,36,0.178571,5,-0.083333,-3,-0.083333,-3,36047010800,11220
108,2010,0,47,47,44,33,33,0.068182,3,0.424242,14,0.424242,14,36047010800,11220
108,2010,1,57,47,53,48,48,0.075472,4,0.1875,9,0.1875,9,36047010800,11220
108,2010,2,49,57,54,35,35,-0.092593,-5,0.4,14,0.4,14,36047010800,11220
108,2010,3,54,49,52,31,31,0.038462,2,0.741935,23,0.741935,23,36047010800,11220
108,2010,4,49,54,36,31,31,0.361111,13,0.580645,18,0.580645,18,36047010800,11220
108,2010,5,41,49,33,37,37,0.242424,8,0.108108,4,0.108108,4,36047010800,11220
110,2001,5,1,0,1,1,1,0,0,0,0,0,0,36047011000,11218
110,2004,3,1,0,0,0,0,1,1,1,1,1,1,36047011000,11218
110,2005,4,1,0,0,0,0,1,1,1,1,1,1,36047011000,11218
110,2006,5,1,0,0,0,0,1,1,1,1,1,1,36047011000,11218
110,2007,4,1,0,0,0,0,1,1,1,1,1,1,36047011000,11218
110,2008,5,1,0,0,0,0,1,1,1,1,1,1,36047011000,11218
114,2001,0,18,18,18,18,18,0,0,0,0,0,0,36047011400,11219
114,2001,1,26,18,26,26,26,0,0,0,0,0,0,36047011400,11219
114,2001,2,12,26,12,12,12,0,0,0,0,0,0,36047011400,11219
114,2001,3,18,12,18,18,18,0,0,0,0,0,0,36047011400,11219
114,2001,4,12,18,12,12,12,0,0,0,0,0,0,36047011400,11219
114,2001,5,15,12,15,15,15,0,0,0,0,0,0,36047011400,11219
114,2002,0,6,6,18,6,6,-0.666667,-12,0,0,0,0,36047011400,11219
114,2002,1,18,6,26,18,18,-0.307692,-8,0,0,0,0,36047011400,11219
114,2002,2,21,18,12,21,21,0.75,9,0,0,0,0,36047011400,11219
114,2002,3,9,21,18,9,9,-0.5,-9,0,0,0,0,36047011400,11219
114,2002,4,18,9,12,18,18,0.5,6,0,0,0,0,36047011400,11219
114,2002,5,10,18,15,10,10,-0.333333,-5,0,0,0,0,36047011400,11219
114,2003,0,18,18,6,18,18,2,12,0,0,0,0,36047011400,11219
114,2003,1,7,18,18,7,7,-0.611111,-11,0,0,0,0,36047011400,11219
114,2003,2,12,7,21,12,12,-0.428571,-9,0,0,0,0,36047011400,11219
114,2003,3,17,12,9,17,17,0.888889,8,0,0,0,0,36047011400,11219
114,2003,4,8,17,18,8,8,-0.555556,-10,0,0,0,0,36047011400,11219
114,2003,5,10,8,10,10,10,0,0,0,0,0,0,36047011400,11219
114,2004,0,11,11,18,18,18,-0.388889,-7,-0.388889,-7,-0.388889,-7,36047011400,11219
114,2004,1,23,11,7,26,26,2.285714,16,-0.115385,-3,-0.115385,-3,36047011400,11219
114,2004,2,9,23,12,12,12,-0.25,-3,-0.25,-3,-0.25,-3,36047011400,11219
114,2004,3,14,9,17,18,18,-0.176471,-3,-0.222222,-4,-0.222222,-4,36047011400,11219
114,2004,4,20,14,8,12,12,1.5,12,0.666667,8,0.666667,8,36047011400,11219
114,2004,5,7,20,10,15,15,-0.3,-3,-0.533333,-8,-0.533333,-8,36047011400,11219
114,2005,0,12,12,11,6,6,0.090909,1,1,6,1,6,36047011400,11219
114,2005,1,10,12,23,18,18,-0.565217,-13,-0.444444,-8,-0.444444,-8,36047011400,11219
114,2005,2,24,10,9,21,21,1.666667,15,0.142857,3,0.142857,3,36047011400,11219
114,2005,3,10,24,14,9,9,-0.285714,-4,0.111111,1,0.111111,1,36047011400,11219
114,2005,4,12,10,20,18,18,-0.4,-8,-0.333333,-6,-0.333333,-6,36047011400,11219
114,2005,5,22,12,7,10,10,2.142857,15,1.2,12,1.2,12,36047011400,11219
114,2006,0,11,11,12,18,18,-0.083333,-1,-0.388889,-7,-0.388889,-7,36047011400,11219
114,2006,1,9,11,10,7,7,-0.1,-1,0.285714,2,0.285714,2,36047011400,11219
114,2006,2,9,9,24,12,12,-0.625,-15,-0.25,-3,-0.25,-3,36047011400,11219
114,2006,3,18,9,10,17,17,0.8,8,0.058824,1,0.058824,1,36047011400,11219
114,2006,4,10,18,12,8,8,-0.166667,-2,0.25,2,0.25,2,36047011400,11219
114,2006,5,13,10,22,10,10,-0.409091,-9,0.3,3,0.3,3,36047011400,11219
114,2007,0,11,11,11,11,11,0,0,0,0,0,0,36047011400,11219
114,2007,1,11,11,9,23,23,0.222222,2,-0.521739,-12,-0.521739,-12,36047011400,11219
114,2007,2,9,11,9,9,9,0,0,0,0,0,0,36047011400,11219
114,2007,3,6,9,18,14,14,-0.666667,-12,-0.571429,-8,-0.571429,-8,36047011400,11219
114,2007,4,15,6,10,20,20,0.5,5,-0.25,-5,-0.25,-5,36047011400,11219
114,2007,5,10,15,13,7,7,-0.230769,-3,0.428571,3,0.428571,3,36047011400,11219
114,2008,0,16,16,11,12,12,0.454545,5,0.333333,4,0.333333,4,36047011400,11219
114,2008,1,11,16,11,10,10,0,0,0.1,1,0.1,1,36047011400,11219
114,2008,2,9,11,9,24,24,0,0,-0.625,-15,-0.625,-15,36047011400,11219
114,2008,3,8,9,6,10,10,0.333333,2,-0.2,-2,-0.2,-2,36047011400,11219
114,2008,4,7,8,15,12,12,-0.533333,-8,-0.416667,-5,-0.416667,-5,36047011400,11219
114,2008,5,14,7,10,22,22,0.4,4,-0.363636,-8,-0.363636,-8,36047011400,11219
114,2009,0,16,16,16,11,11,0,0,0.454545,5,0.454545,5,36047011400,11219
114,2009,1,18,16,11,9,9,0.636364,7,1,9,1,9,36047011400,11219
114,2009,2,13,18,9,9,9,0.444444,4,0.444444,4,0.444444,4,36047011400,11219
114,2009,3,12,13,8,18,18,0.5,4,-0.333333,-6,-0.333333,-6,36047011400,11219
114,2009,4,15,12,7,10,10,1.142857,8,0.5,5,0.5,5,36047011400,11219
114,2009,5,13,15,14,13,13,-0.071429,-1,0,0,0,0,36047011400,11219
114,2010,0,15,15,16,11,11,-0.0625,-1,0.363636,4,0.363636,4,36047011400,11219
114,2010,1,20,15,18,11,11,0.111111,2,0.818182,9,0.818182,9,36047011400,11219
114,2010,2,25,20,13,9,9,0.923077,12,1.777778,16,1.777778,16,36047011400,11219
114,2010,3,12,25,12,6,6,0,0,1,6,1,6,36047011400,11219
114,2010,4,18,12,15,15,15,0.2,3,0.2,3,0.2,3,36047011400,11219
114,2010,5,15,18,13,10,10,0.153846,2,0.5,5,0.5,5,36047011400,11219
116,2001,0,60,60,60,60,60,0,0,0,0,0,0,36047011600,11219
116,2001,1,61,60,61,61,61,0,0,0,0,0,0,36047011600,11219
116,2001,2,39,61,39,39,39,0,0,0,0,0,0,36047011600,11219
116,2001,3,55,39,55,55,55,0,0,0,0,0,0,36047011600,11219
116,2001,4,51,55,51,51,51,0,0,0,0,0,0,36047011600,11219
116,2001,5,38,51,38,38,38,0,0,0,0,0,0,36047011600,11219
116,2002,0,49,49,60,49,49,-0.183333,-11,0,0,0,0,36047011600,11219
116,2002,1,70,49,61,70,70,0.147541,9,0,0,0,0,36047011600,11219
116,2002,2,54,70,39,54,54,0.384615,15,0,0,0,0,36047011600,11219
116,2002,3,46,54,55,46,46,-0.163636,-9,0,0,0,0,36047011600,11219
116,2002,4,54,46,51,54,54,0.058824,3,0,0,0,0,36047011600,11219
116,2002,5,52,54,38,52,52,0.368421,14,0,0,0,0,36047011600,11219
116,2003,0,51,51,49,51,51,0.040816,2,0,0,0,0,36047011600,11219
116,2003,1,55,51,70,55,55,-0.214286,-15,0,0,0,0,36047011600,11219
116,2003,2,60,55,54,60,60,0.111111,6,0,0,0,0,36047011600,11219
116,2003,3,54,60,46,54,54,0.173913,8,0,0,0,0,36047011600,11219
116,2003,4,50,54,54,50,50,-0.074074,-4,0,0,0,0,36047011600,11219
116,2003,5,51,50,52,51,51,-0.019231,-1,0,0,0,0,36047011600,11219
116,2004,0,57,57,51,60,60,0.117647,6,-0.05,-3,-0.05,-3,36047011600,11219
116,2004,1,61,57,55,61,61,0.109091,6,0,0,0,0,36047011600,11219
116,2004,2,60,61,60,39,39,0,0,0.538462,21,0.538462,21,36047011600,11219
116,2004,3,59,60,54,55,55,0.092593,5,0.072727,4,0.072727,4,36047011600,11219
116,2004,4,56,59,50,51,51,0.12,6,0.098039,5,0.098039,5,36047011600,11219
116,2004,5,56,56,51,38,38,0.098039,5,0.473684,18,0.473684,18,36047011600,11219
116,2005,0,73,73,57,49,49,0.280702,16,0.489796,24,0.489796,24,36047011600,11219
116,2005,1,63,73,61,70,70,0.032787,2,-0.1,-7,-0.1,-7,36047011600,11219
116,2005,2,53,63,60,54,54,-0.116667,-7,-0.018519,-1,-0.018519,-1,36047011600,11219
116,2005,3,59,53,59,46,46,0,0,0.282609,13,0.282609,13,36047011600,11219
116,2005,4,54,59,56,54,54,-0.035714,-2,0,0,0,0,36047011600,11219
116,2005,5,58,54,56,52,52,0.035714,2,0.115385,6,0.115385,6,36047011600,11219
116,2006,0,80,80,73,51,51,0.09589,7,0.568627,29,0.568627,29,36047011600,11219
116,2006,1,80,80,63,55,55,0.269841,17,0.454545,25,0.454545,25,36047011600,11219
116,2006,2,55,80,53,60,60,0.037736,2,-0.083333,-5,-0.083333,-5,36047011600,11219
116,2006,3,63,55,59,54,54,0.067797,4,0.166667,9,0.166667,9,36047011600,11219
116,2006,4,63,63,54,50,50,0.166667,9,0.26,13,0.26,13,36047011600,11219
116,2006,5,62,63,58,51,51,0.068966,4,0.215686,11,0.215686,11,36047011600,11219
116,2007,0,54,54,80,57,57,-0.325,-26,-0.052632,-3,-0.052632,-3,36047011600,11219
116,2007,1,79,54,80,61,61,-0.0125,-1,0.295082,18,0.295082,18,36047011600,11219
116,2007,2,72,79,55,60,60,0.309091,17,0.2,12,0.2,12,36047011600,11219
116,2007,3,57,72,63,59,59,-0.095238,-6,-0.033898,-2,-0.033898,-2,36047011600,11219
116,2007,4,59,57,63,56,56,-0.063492,-4,0.053571,3,0.053571,3,36047011600,11219
116,2007,5,59,59,62,56,56,-0.048387,-3,0.053571,3,0.053571,3,36047011600,11219
116,2008,0,86,86,54,73,73,0.592593,32,0.178082,13,0.178082,13,36047011600,11219
116,2008,1,54,86,79,63,63,-0.316456,-25,-0.142857,-9,-0.142857,-9,36047011600,11219
116,2008,2,73,54,72,53,53,0.013889,1,0.377358,20,0.377358,20,36047011600,11219
116,2008,3,76,73,57,59,59,0.333333,19,0.288136,17,0.288136,17,36047011600,11219
116,2008,4,53,76,59,54,54,-0.101695,-6,-0.018519,-1,-0.018519,-1,36047011600,11219
116,2008,5,56,53,59,58,58,-0.050847,-3,-0.034483,-2,-0.034483,-2,36047011600,11219
116,2009,0,112,112,86,80,80,0.302326,26,0.4,32,0.4,32,36047011600,11219
116,2009,1,116,112,54,80,80,1.148148,62,0.45,36,0.45,36,36047011600,11219
116,2009,2,96,116,73,55,55,0.315068,23,0.745455,41,0.745455,41,36047011600,11219
116,2009,3,84,96,76,63,63,0.105263,8,0.333333,21,0.333333,21,36047011600,11219
116,2009,4,89,84,53,63,63,0.679245,36,0.412698,26,0.412698,26,36047011600,11219
116,2009,5,62,89,56,62,62,0.107143,6,0,0,0,0,36047011600,11219
116,2010,0,105,105,112,54,54,-0.0625,-7,0.944444,51,0.944444,51,36047011600,11219
116,2010,1,133,105,116,79,79,0.146552,17,0.683544,54,0.683544,54,36047011600,11219
116,2010,2,116,133,96,72,72,0.208333,20,0.611111,44,0.611111,44,36047011600,11219
116,2010,3,97,116,84,57,57,0.154762,13,0.701754,40,0.701754,40,36047011600,11219
116,2010,4,93,97,89,59,59,0.044944,4,0.576271,34,0.576271,34,36047011600,11219
116,2010,5,87,93,62,59,59,0.403226,25,0.474576,28,0.474576,28,36047011600,11219
118,2001,0,14,14,14,14,14,0,0,0,0,0,0,36047011800,11219
118,2001,1,26,14,26,26,26,0,0,0,0,0,0,36047011800,11219
118,2001,2,23,26,23,23,23,0,0,0,0,0,0,36047011800,11219
118,2001,3,26,23,26,26,26,0,0,0,0,0,0,36047011800,11219
118,2001,4,21,26,21,21,21,0,0,0,0,0,0,36047011800,11219
118,2001,5,22,21,22,22,22,0,0,0,0,0,0,36047011800,11219
118,2002,0,24,24,14,24,24,0.714286,10,0,0,0,0,36047011800,11219
118,2002,1,18,24,26,18,18,-0.307692,-8,0,0,0,0,36047011800,11219
118,2002,2,33,18,23,33,33,0.434783,10,0,0,0,0,36047011800,11219
118,2002,3,22,33,26,22,22,-0.153846,-4,0,0,0,0,36047011800,11219
118,2002,4,27,22,21,27,27,0.285714,6,0,0,0,0,36047011800,11219
118,2002,5,18,27,22,18,18,-0.181818,-4,0,0,0,0,36047011800,11219
118,2003,0,25,25,24,25,25,0.041667,1,0,0,0,0,36047011800,11219
118,2003,1,28,25,18,28,28,0.555556,10,0,0,0,0,36047011800,11219
118,2003,2,16,28,33,16,16,-0.515152,-17,0,0,0,0,36047011800,11219
118,2003,3,32,16,22,32,32,0.454545,10,0,0,0,0,36047011800,11219
118,2003,4,21,32,27,21,21,-0.222222,-6,0,0,0,0,36047011800,11219
118,2003,5,25,21,18,25,25,0.388889,7,0,0,0,0,36047011800,11219
118,2004,0,19,19,25,14,14,-0.24,-6,0.357143,5,0.357143,5,36047011800,11219
118,2004,1,26,19,28,26,26,-0.071429,-2,0,0,0,0,36047011800,11219
118,2004,2,25,26,16,23,23,0.5625,9,0.086957,2,0.086957,2,36047011800,11219
118,2004,3,18,25,32,26,26,-0.4375,-14,-0.307692,-8,-0.307692,-8,36047011800,11219
118,2004,4,29,18,21,21,21,0.380952,8,0.380952,8,0.380952,8,36047011800,11219
118,2004,5,21,29,25,22,22,-0.16,-4,-0.045455,-1,-0.045455,-1,36047011800,11219
118,2005,0,29,29,19,24,24,0.526316,10,0.208333,5,0.208333,5,36047011800,11219
118,2005,1,22,29,26,18,18,-0.153846,-4,0.222222,4,0.222222,4,36047011800,11219
118,2005,2,30,22,25,33,33,0.2,5,-0.090909,-3,-0.090909,-3,36047011800,11219
118,2005,3,21,30,18,22,22,0.166667,3,-0.045455,-1,-0.045455,-1,36047011800,11219
118,2005,4,16,21,29,27,27,-0.448276,-13,-0.407407,-11,-0.407407,-11,36047011800,11219
118,2005,5,29,16,21,18,18,0.380952,8,0.611111,11,0.611111,11,36047011800,11219
118,2006,0,30,30,29,25,25,0.034483,1,0.2,5,0.2,5,36047011800,11219
118,2006,1,24,30,22,28,28,0.090909,2,-0.142857,-4,-0.142857,-4,36047011800,11219
118,2006,2,22,24,30,16,16,-0.266667,-8,0.375,6,0.375,6,36047011800,11219
118,2006,3,31,22,21,32,32,0.47619,10,-0.03125,-1,-0.03125,-1,36047011800,11219
118,2006,4,25,31,16,21,21,0.5625,9,0.190476,4,0.190476,4,36047011800,11219
118,2006,5,19,25,29,25,25,-0.344828,-10,-0.24,-6,-0.24,-6,36047011800,11219
118,2007,0,17,17,30,19,19,-0.433333,-13,-0.105263,-2,-0.105263,-2,36047011800,11219
118,2007,1,34,17,24,26,26,0.416667,10,0.307692,8,0.307692,8,36047011800,11219
118,2007,2,22,34,22,25,25,0,0,-0.12,-3,-0.12,-3,36047011800,11219
118,2007,3,20,22,31,18,18,-0.354839,-11,0.111111,2,0.111111,2,36047011800,11219
118,2007,4,34,20,25,29,29,0.36,9,0.172414,5,0.172414,5,36047011800,11219
118,2007,5,24,34,19,21,21,0.263158,5,0.142857,3,0.142857,3,36047011800,11219
118,2008,0,20,20,17,29,29,0.176471,3,-0.310345,-9,-0.310345,-9,36047011800,11219
118,2008,1,21,20,34,22,22,-0.382353,-13,-0.045455,-1,-0.045455,-1,36047011800,11219
118,2008,2,33,21,22,30,30,0.5,11,0.1,3,0.1,3,36047011800,11219
118,2008,3,21,33,20,21,21,0.05,1,0,0,0,0,36047011800,11219
118,2008,4,24,21,34,16,16,-0.294118,-10,0.5,8,0.5,8,36047011800,11219
118,2008,5,31,24,24,29,29,0.291667,7,0.068966,2,0.068966,2,36047011800,11219
118,2009,0,25,25,20,30,30,0.25,5,-0.166667,-5,-0.166667,-5,36047011800,11219
118,2009,1,29,25,21,24,24,0.380952,8,0.208333,5,0.208333,5,36047011800,11219
118,2009,2,27,29,33,22,22,-0.181818,-6,0.227273,5,0.227273,5,36047011800,11219
118,2009,3,38,27,21,31,31,0.809524,17,0.225806,7,0.225806,7,36047011800,11219
118,2009,4,23,38,24,25,25,-0.041667,-1,-0.08,-2,-0.08,-2,36047011800,11219
118,2009,5,32,23,31,19,19,0.032258,1,0.684211,13,0.684211,13,36047011800,11219
118,2010,0,35,35,25,17,17,0.4,10,1.058824,18,1.058824,18,36047011800,11219
118,2010,1,29,35,29,34,34,0,0,-0.147059,-5,-0.147059,-5,36047011800,11219
118,2010,2,27,29,27,22,22,0,0,0.227273,5,0.227273,5,36047011800,11219
118,2010,3,22,27,38,20,20,-0.421053,-16,0.1,2,0.1,2,36047011800,11219
118,2010,4,29,22,23,34,34,0.26087,6,-0.147059,-5,-0.147059,-5,36047011800,11219
118,2010,5,27,29,32,24,24,-0.15625,-5,0.125,3,0.125,3,36047011800,11219
120,2001,0,11,11,11,11,11,0,0,0,0,0,0,36047012000,11219
120,2001,1,12,11,12,12,12,0,0,0,0,0,0,36047012000,11219
120,2001,2,19,12,19,19,19,0,0,0,0,0,0,36047012000,11219
120,2001,3,16,19,16,16,16,0,0,0,0,0,0,36047012000,11219
120,2001,4,12,16,12,12,12,0,0,0,0,0,0,36047012000,11219
120,2001,5,14,12,14,14,14,0,0,0,0,0,0,36047012000,11219
120,2002,0,13,13,11,13,13,0.181818,2,0,0,0,0,36047012000,11219
120,2002,1,10,13,12,10,10,-0.166667,-2,0,0,0,0,36047012000,11219
120,2002,2,15,10,19,15,15,-0.210526,-4,0,0,0,0,36047012000,11219
120,2002,3,19,15,16,19,19,0.1875,3,0,0,0,0,36047012000,11219
120,2002,4,16,19,12,16,16,0.333333,4,0,0,0,0,36047012000,11219
120,2002,5,11,16,14,11,11,-0.214286,-3,0,0,0,0,36047012000,11219
120,2003,0,13,13,13,13,13,0,0,0,0,0,0,36047012000,11219
120,2003,1,16,13,10,16,16,0.6,6,0,0,0,0,36047012000,11219
120,2003,2,10,16,15,10,10,-0.333333,-5,0,0,0,0,36047012000,11219
120,2003,3,16,10,19,16,16,-0.157895,-3,0,0,0,0,36047012000,11219
120,2003,4,18,16,16,18,18,0.125,2,0,0,0,0,36047012000,11219
120,2003,5,13,18,11,13,13,0.181818,2,0,0,0,0,36047012000,11219
120,2004,0,14,14,13,11,11,0.076923,1,0.272727,3,0.272727,3,36047012000,11219
120,2004,1,15,14,16,12,12,-0.0625,-1,0.25,3,0.25,3,36047012000,11219
120,2004,2,18,15,10,19,19,0.8,8,-0.052632,-1,-0.052632,-1,36047012000,11219
120,2004,3,13,18,16,16,16,-0.1875,-3,-0.1875,-3,-0.1875,-3,36047012000,11219
120,2004,4,14,13,18,12,12,-0.222222,-4,0.166667,2,0.166667,2,36047012000,11219
120,2004,5,18,14,13,14,14,0.384615,5,0.285714,4,0.285714,4,36047012000,11219
120,2005,0,13,13,14,13,13,-0.071429,-1,0,0,0,0,36047012000,11219
120,2005,1,16,13,15,10,10,0.066667,1,0.6,6,0.6,6,36047012000,11219
120,2005,2,14,16,18,15,15,-0.222222,-4,-0.066667,-1,-0.066667,-1,36047012000,11219
120,2005,3,22,14,13,19,19,0.692308,9,0.157895,3,0.157895,3,36047012000,11219
120,2005,4,14,22,14,16,16,0,0,-0.125,-2,-0.125,-2,36047012000,11219
120,2005,5,16,14,18,11,11,-0.111111,-2,0.454545,5,0.454545,5,36047012000,11219
120,2006,0,21,21,13,13,13,0.615385,8,0.615385,8,0.615385,8,36047012000,11219
120,2006,1,11,21,16,16,16,-0.3125,-5,-0.3125,-5,-0.3125,-5,36047012000,11219
120,2006,2,16,11,14,10,10,0.142857,2,0.6,6,0.6,6,36047012000,11219
120,2006,3,18,16,22,16,16,-0.181818,-4,0.125,2,0.125,2,36047012000,11219
120,2006,4,19,18,14,18,18,0.357143,5,0.055556,1,0.055556,1,36047012000,11219
120,2006,5,11,19,16,13,13,-0.3125,-5,-0.153846,-2,-0.153846,-2,36047012000,11219
120,2007,0,11,11,21,14,14,-0.47619,-10,-0.214286,-3,-0.214286,-3,36047012000,11219
120,2007,1,22,11,11,15,15,1,11,0.466667,7,0.466667,7,36047012000,11219
120,2007,2,13,22,16,18,18,-0.1875,-3,-0.277778,-5,-0.277778,-5,36047012000,11219
120,2007,3,16,13,18,13,13,-0.111111,-2,0.230769,3,0.230769,3,36047012000,11219
120,2007,4,15,16,19,14,14,-0.210526,-4,0.071429,1,0.071429,1,36047012000,11219
120,2007,5,19,15,11,18,18,0.727273,8,0.055556,1,0.055556,1,36047012000,11219
120,2008,0,22,22,11,13,13,1,11,0.692308,9,0.692308,9,36047012000,11219
120,2008,1,13,22,22,16,16,-0.409091,-9,-0.1875,-3,-0.1875,-3,36047012000,11219
120,2008,2,23,13,13,14,14,0.769231,10,0.642857,9,0.642857,9,36047012000,11219
120,2008,3,15,23,16,22,22,-0.0625,-1,-0.318182,-7,-0.318182,-7,36047012000,11219
120,2008,4,18,15,15,14,14,0.2,3,0.285714,4,0.285714,4,36047012000,11219
120,2008,5,19,18,19,16,16,0,0,0.1875,3,0.1875,3,36047012000,11219
120,2009,0,21,21,22,21,21,-0.045455,-1,0,0,0,0,36047012000,11219
120,2009,1,25,21,13,11,11,0.923077,12,1.272727,14,1.272727,14,36047012000,11219
120,2009,2,16,25,23,16,16,-0.304348,-7,0,0,0,0,36047012000,11219
120,2009,3,25,16,15,18,18,0.666667,10,0.388889,7,0.388889,7,36047012000,11219
120,2009,4,15,25,18,19,19,-0.166667,-3,-0.210526,-4,-0.210526,-4,36047012000,11219
120,2009,5,17,15,19,11,11,-0.105263,-2,0.545455,6,0.545455,6,36047012000,11219
120,2010,0,18,18,21,11,11,-0.142857,-3,0.636364,7,0.636364,7,36047012000,11219
120,2010,1,23,18,25,22,22,-0.08,-2,0.045455,1,0.045455,1,36047012000,11219
120,2010,2,27,23,16,13,13,0.6875,11,1.076923,14,1.076923,14,36047012000,11219
120,2010,3,19,27,25,16,16,-0.24,-6,0.1875,3,0.1875,3,36047012000,11219
120,2010,4,26,19,15,15,15,0.733333,11,0.733333,11,0.733333,11,36047012000,11219
120,2010,5,18,26,17,19,19,0.058824,1,-0.052632,-1,-0.052632,-1,36047012000,11219
122,2001,0,72,72,72,72,72,0,0,0,0,0,0,36047012200,11220
122,2001,1,80,72,80,80,80,0,0,0,0,0,0,36047012200,11220
122,2001,2,75,80,75,75,75,0,0,0,0,0,0,36047012200,11220
122,2001,3,71,75,71,71,71,0,0,0,0,0,0,36047012200,11220
122,2001,4,81,71,81,81,81,0,0,0,0,0,0,36047012200,11220
122,2001,5,67,81,67,67,67,0,0,0,0,0,0,36047012200,11220
122,2002,0,59,59,72,59,59,-0.180556,-13,0,0,0,0,36047012200,11220
122,2002,1,72,59,80,72,72,-0.1,-8,0,0,0,0,36047012200,11220
122,2002,2,70,72,75,70,70,-0.066667,-5,0,0,0,0,36047012200,11220
122,2002,3,74,70,71,74,74,0.042254,3,0,0,0,0,36047012200,11220
122,2002,4,68,74,81,68,68,-0.160494,-13,0,0,0,0,36047012200,11220
122,2002,5,73,68,67,73,73,0.089552,6,0,0,0,0,36047012200,11220
122,2003,0,55,55,59,55,55,-0.067797,-4,0,0,0,0,36047012200,11220
122,2003,1,55,55,72,55,55,-0.236111,-17,0,0,0,0,36047012200,11220
122,2003,2,76,55,70,76,76,0.085714,6,0,0,0,0,36047012200,11220
122,2003,3,58,76,74,58,58,-0.216216,-16,0,0,0,0,36047012200,11220
122,2003,4,68,58,68,68,68,0,0,0,0,0,0,36047012200,11220
122,2003,5,68,68,73,68,68,-0.068493,-5,0,0,0,0,36047012200,11220
122,2004,0,62,62,55,72,72,0.127273,7,-0.138889,-10,-0.138889,-10,36047012200,11220
122,2004,1,54,62,55,80,80,-0.018182,-1,-0.325,-26,-0.325,-26,36047012200,11220
122,2004,2,61,54,76,75,75,-0.197368,-15,-0.186667,-14,-0.186667,-14,36047012200,11220
122,2004,3,61,61,58,71,71,0.051724,3,-0.140845,-10,-0.140845,-10,36047012200,11220
122,2004,4,48,61,68,81,81,-0.294118,-20,-0.407407,-33,-0.407407,-33,36047012200,11220
122,2004,5,71,48,68,67,67,0.044118,3,0.059701,4,0.059701,4,36047012200,11220
122,2005,0,69,69,62,59,59,0.112903,7,0.169492,10,0.169492,10,36047012200,11220
122,2005,1,65,69,54,72,72,0.203704,11,-0.097222,-7,-0.097222,-7,36047012200,11220
122,2005,2,58,65,61,70,70,-0.04918,-3,-0.171429,-12,-0.171429,-12,36047012200,11220
122,2005,3,52,58,61,74,74,-0.147541,-9,-0.297297,-22,-0.297297,-22,36047012200,11220
122,2005,4,57,52,48,68,68,0.1875,9,-0.161765,-11,-0.161765,-11,36047012200,11220
122,2005,5,48,57,71,73,73,-0.323944,-23,-0.342466,-25,-0.342466,-25,36047012200,11220
122,2006,0,51,51,69,55,55,-0.26087,-18,-0.072727,-4,-0.072727,-4,36047012200,11220
122,2006,1,78,51,65,55,55,0.2,13,0.418182,23,0.418182,23,36047012200,11220
122,2006,2,62,78,58,76,76,0.068966,4,-0.184211,-14,-0.184211,-14,36047012200,11220
122,2006,3,52,62,52,58,58,0,0,-0.103448,-6,-0.103448,-6,36047012200,11220
122,2006,4,47,52,57,68,68,-0.175439,-10,-0.308824,-21,-0.308824,-21,36047012200,11220
122,2006,5,58,47,48,68,68,0.208333,10,-0.147059,-10,-0.147059,-10,36047012200,11220
122,2007,0,41,41,51,62,62,-0.196078,-10,-0.33871,-21,-0.33871,-21,36047012200,11220
122,2007,1,59,41,78,54,54,-0.24359,-19,0.092593,5,0.092593,5,36047012200,11220
122,2007,2,82,59,62,61,61,0.322581,20,0.344262,21,0.344262,21,36047012200,11220
122,2007,3,54,82,52,61,61,0.038462,2,-0.114754,-7,-0.114754,-7,36047012200,11220
122,2007,4,47,54,47,48,48,0,0,-0.020833,-1,-0.020833,-1,36047012200,11220
122,2007,5,49,47,58,71,71,-0.155172,-9,-0.309859,-22,-0.309859,-22,36047012200,11220
122,2008,0,50,50,41,69,69,0.219512,9,-0.275362,-19,-0.275362,-19,36047012200,11220
122,2008,1,54,50,59,65,65,-0.084746,-5,-0.169231,-11,-0.169231,-11,36047012200,11220
122,2008,2,58,54,82,58,58,-0.292683,-24,0,0,0,0,36047012200,11220
122,2008,3,75,58,54,52,52,0.388889,21,0.442308,23,0.442308,23,36047012200,11220
122,2008,4,52,75,47,57,57,0.106383,5,-0.087719,-5,-0.087719,-5,36047012200,11220
122,2008,5,42,52,49,48,48,-0.142857,-7,-0.125,-6,-0.125,-6,36047012200,11220
122,2009,0,71,71,50,51,51,0.42,21,0.392157,20,0.392157,20,36047012200,11220
122,2009,1,64,71,54,78,78,0.185185,10,-0.179487,-14,-0.179487,-14,36047012200,11220
122,2009,2,74,64,58,62,62,0.275862,16,0.193548,12,0.193548,12,36047012200,11220
122,2009,3,62,74,75,52,52,-0.173333,-13,0.192308,10,0.192308,10,36047012200,11220
122,2009,4,77,62,52,47,47,0.480769,25,0.638298,30,0.638298,30,36047012200,11220
122,2009,5,63,77,42,58,58,0.5,21,0.086207,5,0.086207,5,36047012200,11220
122,2010,0,79,79,71,41,41,0.112676,8,0.926829,38,0.926829,38,36047012200,11220
122,2010,1,72,79,64,59,59,0.125,8,0.220339,13,0.220339,13,36047012200,11220
122,2010,2,68,72,74,82,82,-0.081081,-6,-0.170732,-14,-0.170732,-14,36047012200,11220
122,2010,3,75,68,62,54,54,0.209677,13,0.388889,21,0.388889,21,36047012200,11220
122,2010,4,61,75,77,47,47,-0.207792,-16,0.297872,14,0.297872,14,36047012200,11220
122,2010,5,73,61,63,49,49,0.15873,10,0.489796,24,0.489796,24,36047012200,11220
126,2001,0,30,30,30,30,30,0,0,0,0,0,0,,
126,2001,1,23,30,23,23,23,0,0,0,0,0,0,,
126,2001,2,33,23,33,33,33,0,0,0,0,0,0,,
126,2001,3,35,33,35,35,35,0,0,0,0,0,0,,
126,2001,4,26,35,26,26,26,0,0,0,0,0,0,,
126,2001,5,23,26,23,23,23,0,0,0,0,0,0,,
126,2002,0,30,30,30,30,30,0,0,0,0,0,0,,
126,2002,1,26,30,23,26,26,0.130435,3,0,0,0,0,,
126,2002,2,22,26,33,22,22,-0.333333,-11,0,0,0,0,,
126,2002,3,33,22,35,33,33,-0.057143,-2,0,0,0,0,,
126,2002,4,34,33,26,34,34,0.307692,8,0,0,0,0,,
126,2002,5,18,34,23,18,18,-0.217391,-5,0,0,0,0,,
126,2003,0,19,19,30,19,19,-0.366667,-11,0,0,0,0,,
126,2003,1,30,19,26,30,30,0.153846,4,0,0,0,0,,
126,2003,2,19,30,22,19,19,-0.136364,-3,0,0,0,0,,
126,2003,3,23,19,33,23,23,-0.30303,-10,0,0,0,0,,
126,2003,4,28,23,34,28,28,-0.176471,-6,0,0,0,0,,
126,2003,5,31,28,18,31,31,0.722222,13,0,0,0,0,,
126,2004,0,25,25,19,30,30,0.315789,6,-0.166667,-5,-0.166667,-5,,
126,2004,1,22,25,30,23,23,-0.266667,-8,-0.043478,-1,-0.043478,-1,,
126,2004,2,30,22,19,33,33,0.578947,11,-0.090909,-3,-0.090909,-3,,
126,2004,3,21,30,23,35,35,-0.086957,-2,-0.4,-14,-0.4,-14,,
126,2004,4,26,21,28,26,26,-0.071429,-2,0,0,0,0,,
126,2004,5,28,26,31,23,23,-0.096774,-3,0.217391,5,0.217391,5,,
126,2005,0,30,30,25,30,30,0.2,5,0,0,0,0,,
126,2005,1,26,30,22,26,26,0.181818,4,0,0,0,0,,
126,2005,2,22,26,30,22,22,-0.266667,-8,0,0,0,0,,
126,2005,3,31,22,21,33,33,0.47619,10,-0.060606,-2,-0.060606,-2,,
126,2005,4,26,31,26,34,34,0,0,-0.235294,-8,-0.235294,-8,,
126,2005,5,33,26,28,18,18,0.178571,5,0.833333,15,0.833333,15,,
126,2006,0,33,33,30,19,19,0.1,3,0.736842,14,0.736842,14,,
126,2006,1,28,33,26,30,30,0.076923,2,-0.066667,-2,-0.066667,-2,,
126,2006,2,28,28,22,19,19,0.272727,6,0.473684,9,0.473684,9,,
126,2006,3,27,28,31,23,23,-0.129032,-4,0.173913,4,0.173913,4,,
126,2006,4,33,27,26,28,28,0.269231,7,0.178571,5,0.178571,5,,
126,2006,5,28,33,33,31,31,-0.151515,-5,-0.096774,-3,-0.096774,-3,,
126,2007,0,33,33,33,25,25,0,0,0.32,8,0.32,8,,
126,2007,1,31,33,28,22,22,0.107143,3,0.409091,9,0.409091,9,,
126,2007,2,30,31,28,30,30,0.071429,2,0,0,0,0,,
126,2007,3,32,30,27,21,21,0.185185,5,0.52381,11,0.52381,11,,
126,2007,4,27,32,33,26,26,-0.181818,-6,0.038462,1,0.038462,1,,
126,2007,5,32,27,28,28,28,0.142857,4,0.142857,4,0.142857,4,,
126,2008,0,36,36,33,30,30,0.090909,3,0.2,6,0.2,6,,
126,2008,1,33,36,31,26,26,0.064516,2,0.269231,7,0.269231,7,,
126,2008,2,28,33,30,22,22,-0.066667,-2,0.272727,6,0.272727,6,,
126,2008,3,33,28,32,31,31,0.03125,1,0.064516,2,0.064516,2,,
126,2008,4,31,33,27,26,26,0.148148,4,0.192308,5,0.192308,5,,
126,2008,5,26,31,32,33,33,-0.1875,-6,-0.212121,-7,-0.212121,-7,,
126,2009,0,24,24,36,33,33,-0.333333,-12,-0.272727,-9,-0.272727,-9,,
126,2009,1,41,24,33,28,28,0.242424,8,0.464286,13,0.464286,13,,
126,2009,2,35,41,28,28,28,0.25,7,0.25,7,0.25,7,,
126,2009,3,28,35,33,27,27,-0.151515,-5,0.037037,1,0.037037,1,,
126,2009,4,33,28,31,33,33,0.064516,2,0,0,0,0,,
126,2009,5,33,33,26,28,28,0.269231,7,0.178571,5,0.178571,5,,
126,2010,0,37,37,24,33,33,0.541667,13,0.121212,4,0.121212,4,,
126,2010,1,27,37,41,31,31,-0.341463,-14,-0.129032,-4,-0.129032,-4,,
126,2010,2,40,27,35,30,30,0.142857,5,0.333333,10,0.333333,10,,
126,2010,3,38,40,28,32,32,0.357143,10,0.1875,6,0.1875,6,,
126,2010,4,31,38,33,27,27,-0.060606,-2,0.148148,4,0.148148,4,,
126,2010,5,37,31,33,32,32,0.121212,4,0.15625,5,0.15625,5,,
130,2001,0,34,34,34,34,34,0,0,0,0,0,0,36047013000,11209
130,2001,1,50,34,50,50,50,0,0,0,0,0,0,36047013000,11209
130,2001,2,46,50,46,46,46,0,0,0,0,0,0,36047013000,11209
130,2001,3,46,46,46,46,46,0,0,0,0,0,0,36047013000,11209
130,2001,4,32,46,32,32,32,0,0,0,0,0,0,36047013000,11209
130,2001,5,43,32,43,43,43,0,0,0,0,0,0,36047013000,11209
130,2002,0,48,48,34,48,48,0.411765,14,0,0,0,0,36047013000,11209
130,2002,1,37,48,50,37,37,-0.26,-13,0,0,0,0,36047013000,11209
130,2002,2,51,37,46,51,51,0.108696,5,0,0,0,0,36047013000,11209
130,2002,3,50,51,46,50,50,0.086957,4,0,0,0,0,36047013000,11209
130,2002,4,43,50,32,43,43,0.34375,11,0,0,0,0,36047013000,11209
130,2002,5,36,43,43,36,36,-0.162791,-7,0,0,0,0,36047013000,11209
130,2003,0,46,46,48,46,46,-0.041667,-2,0,0,0,0,36047013000,11209
130,2003,1,49,46,37,49,49,0.324324,12,0,0,0,0,36047013000,11209
130,2003,2,38,49,51,38,38,-0.254902,-13,0,0,0,0,36047013000,11209
130,2003,3,61,38,50,61,61,0.22,11,0,0,0,0,36047013000,11209
130,2003,4,49,61,43,49,49,0.139535,6,0,0,0,0,36047013000,11209
130,2003,5,46,49,36,46,46,0.277778,10,0,0,0,0,36047013000,11209
130,2004,0,43,43,46,34,34,-0.065217,-3,0.264706,9,0.264706,9,36047013000,11209
130,2004,1,44,43,49,50,50,-0.102041,-5,-0.12,-6,-0.12,-6,36047013000,11209
130,2004,2,50,44,38,46,46,0.315789,12,0.086957,4,0.086957,4,36047013000,11209
130,2004,3,39,50,61,46,46,-0.360656,-22,-0.152174,-7,-0.152174,-7,36047013000,11209
130,2004,4,53,39,49,32,32,0.081633,4,0.65625,21,0.65625,21,36047013000,11209
130,2004,5,49,53,46,43,43,0.065217,3,0.139535,6,0.139535,6,36047013000,11209
130,2005,0,55,55,43,48,48,0.27907,12,0.145833,7,0.145833,7,36047013000,11209
130,2005,1,48,55,44,37,37,0.090909,4,0.297297,11,0.297297,11,36047013000,11209
130,2005,2,49,48,50,51,51,-0.02,-1,-0.039216,-2,-0.039216,-2,36047013000,11209
130,2005,3,47,49,39,50,50,0.205128,8,-0.06,-3,-0.06,-3,36047013000,11209
130,2005,4,43,47,53,43,43,-0.188679,-10,0,0,0,0,36047013000,11209
130,2005,5,61,43,49,36,36,0.244898,12,0.694444,25,0.694444,25,36047013000,11209
130,2006,0,44,44,55,46,46,-0.2,-11,-0.043478,-2,-0.043478,-2,36047013000,11209
130,2006,1,50,44,48,49,49,0.041667,2,0.020408,1,0.020408,1,36047013000,11209
130,2006,2,52,50,49,38,38,0.061224,3,0.368421,14,0.368421,14,36047013000,11209
130,2006,3,39,52,47,61,61,-0.170213,-8,-0.360656,-22,-0.360656,-22,36047013000,11209
130,2006,4,48,39,43,49,49,0.116279,5,-0.020408,-1,-0.020408,-1,36047013000,11209
130,2006,5,45,48,61,46,46,-0.262295,-16,-0.021739,-1,-0.021739,-1,36047013000,11209
130,2007,0,49,49,44,43,43,0.113636,5,0.139535,6,0.139535,6,36047013000,11209
130,2007,1,37,49,50,44,44,-0.26,-13,-0.159091,-7,-0.159091,-7,36047013000,11209
130,2007,2,47,37,52,50,50,-0.096154,-5,-0.06,-3,-0.06,-3,36047013000,11209
130,2007,3,51,47,39,39,39,0.307692,12,0.307692,12,0.307692,12,36047013000,11209
130,2007,4,34,51,48,53,53,-0.291667,-14,-0.358491,-19,-0.358491,-19,36047013000,11209
130,2007,5,45,34,45,49,49,0,0,-0.081633,-4,-0.081633,-4,36047013000,11209
130,2008,0,37,37,49,55,55,-0.244898,-12,-0.327273,-18,-0.327273,-18,36047013000,11209
130,2008,1,53,37,37,48,48,0.432432,16,0.104167,5,0.104167,5,36047013000,11209
130,2008,2,33,53,47,49,49,-0.297872,-14,-0.326531,-16,-0.326531,-16,36047013000,11209
130,2008,3,45,33,51,47,47,-0.117647,-6,-0.042553,-2,-0.042553,-2,36047013000,11209
130,2008,4,47,45,34,43,43,0.382353,13,0.093023,4,0.093023,4,36047013000,11209
130,2008,5,43,47,45,61,61,-0.044444,-2,-0.295082,-18,-0.295082,-18,36047013000,11209
130,2009,0,57,57,37,44,44,0.540541,20,0.295455,13,0.295455,13,36047013000,11209
130,2009,1,46,57,53,50,50,-0.132075,-7,-0.08,-4,-0.08,-4,36047013000,11209
130,2009,2,55,46,33,52,52,0.666667,22,0.057692,3,0.057692,3,36047013000,11209
130,2009,3,31,55,45,39,39,-0.311111,-14,-0.205128,-8,-0.205128,-8,36047013000,11209
130,2009,4,46,31,47,48,48,-0.021277,-1,-0.041667,-2,-0.041667,-2,36047013000,11209
130,2009,5,43,46,43,45,45,0,0,-0.044444,-2,-0.044444,-2,36047013000,11209
130,2010,0,55,55,57,49,49,-0.035088,-2,0.122449,6,0.122449,6,36047013000,11209
130,2010,1,56,55,46,37,37,0.217391,10,0.513514,19,0.513514,19,36047013000,11209
130,2010,2,41,56,55,47,47,-0.254545,-14,-0.12766,-6,-0.12766,-6,36047013000,11209
130,2010,3,53,41,31,51,51,0.709677,22,0.039216,2,0.039216,2,36047013000,11209
130,2010,4,29,53,46,34,34,-0.369565,-17,-0.147059,-5,-0.147059,-5,36047013000,11209
130,2010,5,49,29,43,45,45,0.139535,6,0.088889,4,0.088889,4,36047013000,11209
132,2001,0,21,21,21,21,21,0,0,0,0,0,0,36047013200,11220
132,2001,1,18,21,18,18,18,0,0,0,0,0,0,36047013200,11220
132,2001,2,19,18,19,19,19,0,0,0,0,0,0,36047013200,11220
132,2001,3,25,19,25,25,25,0,0,0,0,0,0,36047013200,11220
132,2001,4,24,25,24,24,24,0,0,0,0,0,0,36047013200,11220
132,2001,5,15,24,15,15,15,0,0,0,0,0,0,36047013200,11220
132,2002,0,17,17,21,17,17,-0.190476,-4,0,0,0,0,36047013200,11220
132,2002,1,18,17,18,18,18,0,0,0,0,0,0,36047013200,11220
132,2002,2,26,18,19,26,26,0.368421,7,0,0,0,0,36047013200,11220
132,2002,3,20,26,25,20,20,-0.2,-5,0,0,0,0,36047013200,11220
132,2002,4,28,20,24,28,28,0.166667,4,0,0,0,0,36047013200,11220
132,2002,5,24,28,15,24,24,0.6,9,0,0,0,0,36047013200,11220
132,2003,0,15,15,17,15,15,-0.117647,-2,0,0,0,0,36047013200,11220
132,2003,1,19,15,18,19,19,0.055556,1,0,0,0,0,36047013200,11220
132,2003,2,17,19,26,17,17,-0.346154,-9,0,0,0,0,36047013200,11220
132,2003,3,23,17,20,23,23,0.15,3,0,0,0,0,36047013200,11220
132,2003,4,18,23,28,18,18,-0.357143,-10,0,0,0,0,36047013200,11220
132,2003,5,22,18,24,22,22,-0.083333,-2,0,0,0,0,36047013200,11220
132,2004,0,19,19,15,21,21,0.266667,4,-0.095238,-2,-0.095238,-2,36047013200,11220
132,2004,1,20,19,19,18,18,0.052632,1,0.111111,2,0.111111,2,36047013200,11220
132,2004,2,21,20,17,19,19,0.235294,4,0.105263,2,0.105263,2,36047013200,11220
132,2004,3,25,21,23,25,25,0.086957,2,0,0,0,0,36047013200,11220
132,2004,4,27,25,18,24,24,0.5,9,0.125,3,0.125,3,36047013200,11220
132,2004,5,20,27,22,15,15,-0.090909,-2,0.333333,5,0.333333,5,36047013200,11220
132,2005,0,16,16,19,17,17,-0.157895,-3,-0.058824,-1,-0.058824,-1,36047013200,11220
132,2005,1,19,16,20,18,18,-0.05,-1,0.055556,1,0.055556,1,36047013200,11220
132,2005,2,20,19,21,26,26,-0.047619,-1,-0.230769,-6,-0.230769,-6,36047013200,11220
132,2005,3,26,20,25,20,20,0.04,1,0.3,6,0.3,6,36047013200,11220
132,2005,4,26,26,27,28,28,-0.037037,-1,-0.071429,-2,-0.071429,-2,36047013200,11220
132,2005,5,29,26,20,24,24,0.45,9,0.208333,5,0.208333,5,36047013200,11220
132,2006,0,25,25,16,15,15,0.5625,9,0.666667,10,0.666667,10,36047013200,11220
132,2006,1,25,25,19,19,19,0.315789,6,0.315789,6,0.315789,6,36047013200,11220
132,2006,2,19,25,20,17,17,-0.05,-1,0.117647,2,0.117647,2,36047013200,11220
132,2006,3,23,19,26,23,23,-0.115385,-3,0,0,0,0,36047013200,11220
132,2006,4,27,23,26,18,18,0.038462,1,0.5,9,0.5,9,36047013200,11220
132,2006,5,24,27,29,22,22,-0.172414,-5,0.090909,2,0.090909,2,36047013200,11220
132,2007,0,26,26,25,19,19,0.04,1,0.368421,7,0.368421,7,36047013200,11220
132,2007,1,18,26,25,20,20,-0.28,-7,-0.1,-2,-0.1,-2,36047013200,11220
132,2007,2,27,18,19,21,21,0.421053,8,0.285714,6,0.285714,6,36047013200,11220
132,2007,3,15,27,23,25,25,-0.347826,-8,-0.4,-10,-0.4,-10,36047013200,11220
132,2007,4,25,15,27,27,27,-0.074074,-2,-0.074074,-2,-0.074074,-2,36047013200,11220
132,2007,5,24,25,24,20,20,0,0,0.2,4,0.2,4,36047013200,11220
132,2008,0,25,25,26,16,16,-0.038462,-1,0.5625,9,0.5625,9,36047013200,11220
132,2008,1,27,25,18,19,19,0.5,9,0.421053,8,0.421053,8,36047013200,11220
132,2008,2,19,27,27,20,20,-0.296296,-8,-0.05,-1,-0.05,-1,36047013200,11220
132,2008,3,26,19,15,26,26,0.733333,11,0,0,0,0,36047013200,11220
132,2008,4,18,26,25,26,26,-0.28,-7,-0.307692,-8,-0.307692,-8,36047013200,11220
132,2008,5,26,18,24,29,29,0.083333,2,-0.103448,-3,-0.103448,-3,36047013200,11220
132,2009,0,21,21,25,25,25,-0.16,-4,-0.16,-4,-0.16,-4,36047013200,11220
132,2009,1,32,21,27,25,25,0.185185,5,0.28,7,0.28,7,36047013200,11220
132,2009,2,29,32,19,19,19,0.526316,10,0.526316,10,0.526316,10,36047013200,11220
132,2009,3,22,29,26,23,23,-0.153846,-4,-0.043478,-1,-0.043478,-1,36047013200,11220
132,2009,4,25,22,18,27,27,0.388889,7,-0.074074,-2,-0.074074,-2,36047013200,11220
132,2009,5,19,25,26,24,24,-0.269231,-7,-0.208333,-5,-0.208333,-5,36047013200,11220
132,2010,0,26,26,21,26,26,0.238095,5,0,0,0,0,36047013200,11220
132,2010,1,28,26,32,18,18,-0.125,-4,0.555556,10,0.555556,10,36047013200,11220
132,2010,2,30,28,29,27,27,0.034483,1,0.111111,3,0.111111,3,36047013200,11220
132,2010,3,32,30,22,15,15,0.454545,10,1.133333,17,1.133333,17,36047013200,11220
132,2010,4,20,32,25,25,25,-0.2,-5,-0.2,-5,-0.2,-5,36047013200,11220
132,2010,5,28,20,19,24,24,0.473684,9,0.166667,4,0.166667,4,36047013200,11220
134,2001,0,24,24,24,24,24,0,0,0,0,0,0,36047013400,11209
134,2001,1,32,24,32,32,32,0,0,0,0,0,0,36047013400,11209
134,2001,2,31,32,31,31,31,0,0,0,0,0,0,36047013400,11209
134,2001,3,31,31,31,31,31,0,0,0,0,0,0,36047013400,11209
134,2001,4,35,31,35,35,35,0,0,0,0,0,0,36047013400,11209
134,2001,5,16,35,16,16,16,0,0,0,0,0,0,36047013400,11209
134,2002,0,29,29,24,29,29,0.208333,5,0,0,0,0,36047013400,11209
134,2002,1,24,29,32,24,24,-0.25,-8,0,0,0,0,36047013400,11209
134,2002,2,39,24,31,39,39,0.258065,8,0,0,0,0,36047013400,11209
134,2002,3,31,39,31,31,31,0,0,0,0,0,0,36047013400,11209
134,2002,4,33,31,35,33,33,-0.057143,-2,0,0,0,0,36047013400,11209
134,2002,5,40,33,16,40,40,1.5,24,0,0,0,0,36047013400,11209
134,2003,0,31,31,29,31,31,0.068966,2,0,0,0,0,36047013400,11209
134,2003,1,30,31,24,30,30,0.25,6,0,0,0,0,36047013400,11209
134,2003,2,28,30,39,28,28,-0.282051,-11,0,0,0,0,36047013400,11209
134,2003,3,38,28,31,38,38,0.225806,7,0,0,0,0,36047013400,11209
134,2003,4,34,38,33,34,34,0.030303,1,0,0,0,0,36047013400,11209
134,2003,5,30,34,40,30,30,-0.25,-10,0,0,0,0,36047013400,11209
134,2004,0,32,32,31,24,24,0.032258,1,0.333333,8,0.333333,8,36047013400,11209
134,2004,1,32,32,30,32,32,0.066667,2,0,0,0,0,36047013400,11209
134,2004,2,30,32,28,31,31,0.071429,2,-0.032258,-1,-0.032258,-1,36047013400,11209
134,2004,3,33,30,38,31,31,-0.131579,-5,0.064516,2,0.064516,2,36047013400,11209
134,2004,4,31,33,34,35,35,-0.088235,-3,-0.114286,-4,-0.114286,-4,36047013400,11209
134,2004,5,33,31,30,16,16,0.1,3,1.0625,17,1.0625,17,36047013400,11209
134,2005,0,27,27,32,29,29,-0.15625,-5,-0.068966,-2,-0.068966,-2,36047013400,11209
134,2005,1,29,27,32,24,24,-0.09375,-3,0.208333,5,0.208333,5,36047013400,11209
134,2005,2,30,29,30,39,39,0,0,-0.230769,-9,-0.230769,-9,36047013400,11209
134,2005,3,31,30,33,31,31,-0.060606,-2,0,0,0,0,36047013400,11209
134,2005,4,28,31,31,33,33,-0.096774,-3,-0.151515,-5,-0.151515,-5,36047013400,11209
134,2005,5,31,28,33,40,40,-0.060606,-2,-0.225,-9,-0.225,-9,36047013400,11209
134,2006,0,25,25,27,31,31,-0.074074,-2,-0.193548,-6,-0.193548,-6,36047013400,11209
134,2006,1,31,25,29,30,30,0.068966,2,0.033333,1,0.033333,1,36047013400,11209
134,2006,2,32,31,30,28,28,0.066667,2,0.142857,4,0.142857,4,36047013400,11209
134,2006,3,33,32,31,38,38,0.064516,2,-0.131579,-5,-0.131579,-5,36047013400,11209
134,2006,4,30,33,28,34,34,0.071429,2,-0.117647,-4,-0.117647,-4,36047013400,11209
134,2006,5,24,30,31,30,30,-0.225806,-7,-0.2,-6,-0.2,-6,36047013400,11209
134,2007,0,31,31,25,32,32,0.24,6,-0.03125,-1,-0.03125,-1,36047013400,11209
134,2007,1,22,31,31,32,32,-0.290323,-9,-0.3125,-10,-0.3125,-10,36047013400,11209
134,2007,2,34,22,32,30,30,0.0625,2,0.133333,4,0.133333,4,36047013400,11209
134,2007,3,33,34,33,33,33,0,0,0,0,0,0,36047013400,11209
134,2007,4,31,33,30,31,31,0.033333,1,0,0,0,0,36047013400,11209
134,2007,5,27,31,24,33,33,0.125,3,-0.181818,-6,-0.181818,-6,36047013400,11209
134,2008,0,32,32,31,27,27,0.032258,1,0.185185,5,0.185185,5,36047013400,11209
134,2008,1,32,32,22,29,29,0.454545,10,0.103448,3,0.103448,3,36047013400,11209
134,2008,2,21,32,34,30,30,-0.382353,-13,-0.3,-9,-0.3,-9,36047013400,11209
134,2008,3,36,21,33,31,31,0.090909,3,0.16129,5,0.16129,5,36047013400,11209
134,2008,4,31,36,31,28,28,0,0,0.107143,3,0.107143,3,36047013400,11209
134,2008,5,31,31,27,31,31,0.148148,4,0,0,0,0,36047013400,11209
134,2009,0,28,28,32,25,25,-0.125,-4,0.12,3,0.12,3,36047013400,11209
134,2009,1,36,28,32,31,31,0.125,4,0.16129,5,0.16129,5,36047013400,11209
134,2009,2,33,36,21,32,32,0.571429,12,0.03125,1,0.03125,1,36047013400,11209
134,2009,3,21,33,36,33,33,-0.416667,-15,-0.363636,-12,-0.363636,-12,36047013400,11209
134,2009,4,35,21,31,30,30,0.129032,4,0.166667,5,0.166667,5,36047013400,11209
134,2009,5,31,35,31,24,24,0,0,0.291667,7,0.291667,7,36047013400,11209
134,2010,0,37,37,28,31,31,0.321429,9,0.193548,6,0.193548,6,36047013400,11209
134,2010,1,41,37,36,22,22,0.138889,5,0.863636,19,0.863636,19,36047013400,11209
134,2010,2,41,41,33,34,34,0.242424,8,0.205882,7,0.205882,7,36047013400,11209
134,2010,3,32,41,21,33,33,0.52381,11,-0.030303,-1,-0.030303,-1,36047013400,11209
134,2010,4,25,32,35,31,31,-0.285714,-10,-0.193548,-6,-0.193548,-6,36047013400,11209
134,2010,5,36,25,31,27,27,0.16129,5,0.333333,9,0.333333,9,36047013400,11209
136,2001,0,31,31,31,31,31,0,0,0,0,0,0,36047013600,11209
136,2001,1,22,31,22,22,22,0,0,0,0,0,0,36047013600,11209
136,2001,2,24,22,24,24,24,0,0,0,0,0,0,36047013600,11209
136,2001,3,33,24,33,33,33,0,0,0,0,0,0,36047013600,11209
136,2001,4,18,33,18,18,18,0,0,0,0,0,0,36047013600,11209
136,2001,5,24,18,24,24,24,0,0,0,0,0,0,36047013600,11209
136,2002,0,21,21,31,21,21,-0.322581,-10,0,0,0,0,36047013600,11209
136,2002,1,29,21,22,29,29,0.318182,7,0,0,0,0,36047013600,11209
136,2002,2,22,29,24,22,22,-0.083333,-2,0,0,0,0,36047013600,11209
136,2002,3,26,22,33,26,26,-0.212121,-7,0,0,0,0,36047013600,11209
136,2002,4,31,26,18,31,31,0.722222,13,0,0,0,0,36047013600,11209
136,2002,5,20,31,24,20,20,-0.166667,-4,0,0,0,0,36047013600,11209
136,2003,0,23,23,21,23,23,0.095238,2,0,0,0,0,36047013600,11209
136,2003,1,26,23,29,26,26,-0.103448,-3,0,0,0,0,36047013600,11209
136,2003,2,29,26,22,29,29,0.318182,7,0,0,0,0,36047013600,11209
136,2003,3,24,29,26,24,24,-0.076923,-2,0,0,0,0,36047013600,11209
136,2003,4,30,24,31,30,30,-0.032258,-1,0,0,0,0,36047013600,11209
136,2003,5,28,30,20,28,28,0.4,8,0,0,0,0,36047013600,11209
136,2004,0,34,34,23,31,31,0.478261,11,0.096774,3,0.096774,3,36047013600,11209
136,2004,1,24,34,26,22,22,-0.076923,-2,0.090909,2,0.090909,2,36047013600,11209
136,2004,2,25,24,29,24,24,-0.137931,-4,0.041667,1,0.041667,1,36047013600,11209
136,2004,3,27,25,24,33,33,0.125,3,-0.181818,-6,-0.181818,-6,36047013600,11209
136,2004,4,22,27,30,18,18,-0.266667,-8,0.222222,4,0.222222,4,36047013600,11209
136,2004,5,28,22,28,24,24,0,0,0.166667,4,0.166667,4,36047013600,11209
136,2005,0,22,22,34,21,21,-0.352941,-12,0.047619,1,0.047619,1,36047013600,11209
136,2005,1,31,22,24,29,29,0.291667,7,0.068966,2,0.068966,2,36047013600,11209
136,2005,2,29,31,25,22,22,0.16,4,0.318182,7,0.318182,7,36047013600,11209
136,2005,3,25,29,27,26,26,-0.074074,-2,-0.038462,-1,-0.038462,-1,36047013600,11209
136,2005,4,27,25,22,31,31,0.227273,5,-0.129032,-4,-0.129032,-4,36047013600,11209
136,2005,5,25,27,28,20,20,-0.107143,-3,0.25,5,0.25,5,36047013600,11209
136,2006,0,35,35,22,23,23,0.590909,13,0.521739,12,0.521739,12,36047013600,11209
136,2006,1,17,35,31,26,26,-0.451613,-14,-0.346154,-9,-0.346154,-9,36047013600,11209
136,2006,2,29,17,29,29,29,0,0,0,0,0,0,36047013600,11209
136,2006,3,30,29,25,24,24,0.2,5,0.25,6,0.25,6,36047013600,11209
136,2006,4,26,30,27,30,30,-0.037037,-1,-0.133333,-4,-0.133333,-4,36047013600,11209
136,2006,5,30,26,25,28,28,0.2,5,0.071429,2,0.071429,2,36047013600,11209
136,2007,0,28,28,35,34,34,-0.2,-7,-0.176471,-6,-0.176471,-6,36047013600,11209
136,2007,1,34,28,17,24,24,1,17,0.416667,10,0.416667,10,36047013600,11209
136,2007,2,17,34,29,25,25,-0.413793,-12,-0.32,-8,-0.32,-8,36047013600,11209
136,2007,3,30,17,30,27,27,0,0,0.111111,3,0.111111,3,36047013600,11209
136,2007,4,28,30,26,22,22,0.076923,2,0.272727,6,0.272727,6,36047013600,11209
136,2007,5,26,28,30,28,28,-0.133333,-4,-0.071429,-2,-0.071429,-2,36047013600,11209
136,2008,0,26,26,28,22,22,-0.071429,-2,0.181818,4,0.181818,4,36047013600,11209
136,2008,1,31,26,34,31,31,-0.088235,-3,0,0,0,0,36047013600,11209
136,2008,2,33,31,17,29,29,0.941176,16,0.137931,4,0.137931,4,36047013600,11209
136,2008,3,15,33,30,25,25,-0.5,-15,-0.4,-10,-0.4,-10,36047013600,11209
136,2008,4,26,15,28,27,27,-0.071429,-2,-0.037037,-1,-0.037037,-1,36047013600,11209
136,2008,5,29,26,26,25,25,0.115385,3,0.16,4,0.16,4,36047013600,11209
136,2009,0,36,36,26,35,35,0.384615,10,0.028571,1,0.028571,1,36047013600,11209
136,2009,1,32,36,31,17,17,0.032258,1,0.882353,15,0.882353,15,36047013600,11209
136,2009,2,32,32,33,29,29,-0.030303,-1,0.103448,3,0.103448,3,36047013600,11209
136,2009,3,34,32,15,30,30,1.266667,19,0.133333,4,0.133333,4,36047013600,11209
136,2009,4,17,34,26,26,26,-0.346154,-9,-0.346154,-9,-0.346154,-9,36047013600,11209
136,2009,5,28,17,29,30,30,-0.034483,-1,-0.066667,-2,-0.066667,-2,36047013600,11209
136,2010,0,37,37,36,28,28,0.027778,1,0.321429,9,0.321429,9,36047013600,11209
136,2010,1,37,37,32,34,34,0.15625,5,0.088235,3,0.088235,3,36047013600,11209
136,2010,2,36,37,32,17,17,0.125,4,1.117647,19,1.117647,19,36047013600,11209
136,2010,3,33,36,34,30,30,-0.029412,-1,0.1,3,0.1,3,36047013600,11209
136,2010,4,31,33,17,28,28,0.823529,14,0.107143,3,0.107143,3,36047013600,11209
136,2010,5,23,31,28,26,26,-0.178571,-5,-0.115385,-3,-0.115385,-3,36047013600,11209
138,2001,0,13,13,13,13,13,0,0,0,0,0,0,36047013800,11209
138,2001,1,18,13,18,18,18,0,0,0,0,0,0,36047013800,11209
138,2001,2,6,18,6,6,6,0,0,0,0,0,0,36047013800,11209
138,2001,3,20,6,20,20,20,0,0,0,0,0,0,36047013800,11209
138,2001,4,7,20,7,7,7,0,0,0,0,0,0,36047013800,11209
138,2001,5,15,7,15,15,15,0,0,0,0,0,0,36047013800,11209
138,2002,0,15,15,13,15,15,0.153846,2,0,0,0,0,36047013800,11209
138,2002,1,12,15,18,12,12,-0.333333,-6,0,0,0,0,36047013800,11209
138,2002,2,16,12,6,16,16,1.666667,10,0,0,0,0,36047013800,11209
138,2002,3,7,16,20,7,7,-0.65,-13,0,0,0,0,36047013800,11209
138,2002,4,18,7,7,18,18,1.571429,11,0,0,0,0,36047013800,11209
138,2002,5,7,18,15,7,7,-0.533333,-8,0,0,0,0,36047013800,11209
138,2003,0,11,11,15,11,11,-0.266667,-4,0,0,0,0,36047013800,11209
138,2003,1,14,11,12,14,14,0.166667,2,0,0,0,0,36047013800,11209
138,2003,2,14,14,16,14,14,-0.125,-2,0,0,0,0,36047013800,11209
138,2003,3,12,14,7,12,12,0.714286,5,0,0,0,0,36047013800,11209
138,2003,4,5,12,18,5,5,-0.722222,-13,0,0,0,0,36047013800,11209
138,2003,5,16,5,7,16,16,1.285714,9,0,0,0,0,36047013800,11209
138,2004,0,15,15,11,13,13,0.363636,4,0.153846,2,0.153846,2,36047013800,11209
138,2004,1,8,15,14,18,18,-0.428571,-6,-0.555556,-10,-0.555556,-10,36047013800,11209
138,2004,2,14,8,14,6,6,0,0,1.333333,8,1.333333,8,36047013800,11209
138,2004,3,17,14,12,20,20,0.416667,5,-0.15,-3,-0.15,-3,36047013800,11209
138,2004,4,12,17,5,7,7,1.4,7,0.714286,5,0.714286,5,36047013800,11209
138,2004,5,6,12,16,15,15,-0.625,-10,-0.6,-9,-0.6,-9,36047013800,11209
138,2005,0,14,14,15,15,15,-0.066667,-1,-0.066667,-1,-0.066667,-1,36047013800,11209
138,2005,1,19,14,8,12,12,1.375,11,0.583333,7,0.583333,7,36047013800,11209
138,2005,2,9,19,14,16,16,-0.357143,-5,-0.4375,-7,-0.4375,-7,36047013800,11209
138,2005,3,15,9,17,7,7,-0.117647,-2,1.142857,8,1.142857,8,36047013800,11209
138,2005,4,15,15,12,18,18,0.25,3,-0.166667,-3,-0.166667,-3,36047013800,11209
138,2005,5,11,15,6,7,7,0.833333,5,0.571429,4,0.571429,4,36047013800,11209
138,2006,0,15,15,14,11,11,0.071429,1,0.363636,4,0.363636,4,36047013800,11209
138,2006,1,18,15,19,14,14,-0.052632,-1,0.285714,4,0.285714,4,36047013800,11209
138,2006,2,22,18,9,14,14,1.444444,13,0.571429,8,0.571429,8,36047013800,11209
138,2006,3,13,22,15,12,12,-0.133333,-2,0.083333,1,0.083333,1,36047013800,11209
138,2006,4,15,13,15,5,5,0,0,2,10,2,10,36047013800,11209
138,2006,5,15,15,11,16,16,0.363636,4,-0.0625,-1,-0.0625,-1,36047013800,11209
138,2007,0,10,10,15,15,15,-0.333333,-5,-0.333333,-5,-0.333333,-5,36047013800,11209
138,2007,1,12,10,18,8,8,-0.333333,-6,0.5,4,0.5,4,36047013800,11209
138,2007,2,14,12,22,14,14,-0.363636,-8,0,0,0,0,36047013800,11209
138,2007,3,20,14,13,17,17,0.538462,7,0.176471,3,0.176471,3,36047013800,11209
138,2007,4,8,20,15,12,12,-0.466667,-7,-0.333333,-4,-0.333333,-4,36047013800,11209
138,2007,5,11,8,15,6,6,-0.266667,-4,0.833333,5,0.833333,5,36047013800,11209
138,2008,0,24,24,10,14,14,1.4,14,0.714286,10,0.714286,10,36047013800,11209
138,2008,1,8,24,12,19,19,-0.333333,-4,-0.578947,-11,-0.578947,-11,36047013800,11209
138,2008,2,14,8,14,9,9,0,0,0.555556,5,0.555556,5,36047013800,11209
138,2008,3,14,14,20,15,15,-0.3,-6,-0.066667,-1,-0.066667,-1,36047013800,11209
138,2008,4,18,14,8,15,15,1.25,10,0.2,3,0.2,3,36047013800,11209
138,2008,5,12,18,11,11,11,0.090909,1,0.090909,1,0.090909,1,36047013800,11209
138,2009,0,10,10,24,15,15,-0.583333,-14,-0.333333,-5,-0.333333,-5,36047013800,11209
138,2009,1,30,10,8,18,18,2.75,22,0.666667,12,0.666667,12,36047013800,11209
138,2009,2,13,30,14,22,22,-0.071429,-1,-0.409091,-9,-0.409091,-9,36047013800,11209
138,2009,3,12,13,14,13,13,-0.142857,-2,-0.076923,-1,-0.076923,-1,36047013800,11209
138,2009,4,12,12,18,15,15,-0.333333,-6,-0.2,-3,-0.2,-3,36047013800,11209
138,2009,5,16,12,12,15,15,0.333333,4,0.066667,1,0.066667,1,36047013800,11209
138,2010,0,21,21,10,10,10,1.1,11,1.1,11,1.1,11,36047013800,11209
138,2010,1,13,21,30,12,12,-0.566667,-17,0.083333,1,0.083333,1,36047013800,11209
138,2010,2,30,13,13,14,14,1.307692,17,1.142857,16,1.142857,16,36047013800,11209
138,2010,3,16,30,12,20,20,0.333333,4,-0.2,-4,-0.2,-4,36047013800,11209
138,2010,4,13,16,12,8,8,0.083333,1,0.625,5,0.625,5,36047013800,11209
138,2010,5,11,13,16,11,11,-0.3125,-5,0,0,0,0,36047013800,11209
140,2001,0,15,15,15,15,15,0,0,0,0,0,0,36047014000,11228
140,2001,1,13,15,13,13,13,0,0,0,0,0,0,36047014000,11228
140,2001,2,11,13,11,11,11,0,0,0,0,0,0,36047014000,11228
140,2001,3,9,11,9,9,9,0,0,0,0,0,0,36047014000,11228
140,2001,4,9,9,9,9,9,0,0,0,0,0,0,36047014000,11228
140,2001,5,7,9,7,7,7,0,0,0,0,0,0,36047014000,11228
140,2002,0,19,19,15,19,19,0.266667,4,0,0,0,0,36047014000,11228
140,2002,1,17,19,13,17,17,0.307692,4,0,0,0,0,36047014000,11228
140,2002,2,12,17,11,12,12,0.090909,1,0,0,0,0,36047014000,11228
140,2002,3,8,12,9,8,8,-0.111111,-1,0,0,0,0,36047014000,11228
140,2002,4,12,8,9,12,12,0.333333,3,0,0,0,0,36047014000,11228
140,2002,5,9,12,7,9,9,0.285714,2,0,0,0,0,36047014000,11228
140,2003,0,13,13,19,13,13,-0.315789,-6,0,0,0,0,36047014000,11228
140,2003,1,18,13,17,18,18,0.058824,1,0,0,0,0,36047014000,11228
140,2003,2,15,18,12,15,15,0.25,3,0,0,0,0,36047014000,11228
140,2003,3,14,15,8,14,14,0.75,6,0,0,0,0,36047014000,11228
140,2003,4,8,14,12,8,8,-0.333333,-4,0,0,0,0,36047014000,11228
140,2003,5,10,8,9,10,10,0.111111,1,0,0,0,0,36047014000,11228
140,2004,0,5,5,13,15,15,-0.615385,-8,-0.666667,-10,-0.666667,-10,36047014000,11228
140,2004,1,16,5,18,13,13,-0.111111,-2,0.230769,3,0.230769,3,36047014000,11228
140,2004,2,18,16,15,11,11,0.2,3,0.636364,7,0.636364,7,36047014000,11228
140,2004,3,17,18,14,9,9,0.214286,3,0.888889,8,0.888889,8,36047014000,11228
140,2004,4,12,17,8,9,9,0.5,4,0.333333,3,0.333333,3,36047014000,11228
140,2004,5,8,12,10,7,7,-0.2,-2,0.142857,1,0.142857,1,36047014000,11228
140,2005,0,8,8,5,19,19,0.6,3,-0.578947,-11,-0.578947,-11,36047014000,11228
140,2005,1,6,8,16,17,17,-0.625,-10,-0.647059,-11,-0.647059,-11,36047014000,11228
140,2005,2,18,6,18,12,12,0,0,0.5,6,0.5,6,36047014000,11228
140,2005,3,17,18,17,8,8,0,0,1.125,9,1.125,9,36047014000,11228
140,2005,4,16,17,12,12,12,0.333333,4,0.333333,4,0.333333,4,36047014000,11228
140,2005,5,12,16,8,9,9,0.5,4,0.333333,3,0.333333,3,36047014000,11228
140,2006,0,7,7,8,13,13,-0.125,-1,-0.461538,-6,-0.461538,-6,36047014000,11228
140,2006,1,8,7,6,18,18,0.333333,2,-0.555556,-10,-0.555556,-10,36047014000,11228
140,2006,2,7,8,18,15,15,-0.611111,-11,-0.533333,-8,-0.533333,-8,36047014000,11228
140,2006,3,20,7,17,14,14,0.176471,3,0.428571,6,0.428571,6,36047014000,11228
140,2006,4,16,20,16,8,8,0,0,1,8,1,8,36047014000,11228
140,2006,5,14,16,12,10,10,0.166667,2,0.4,4,0.4,4,36047014000,11228
140,2007,0,8,8,7,5,5,0.142857,1,0.6,3,0.6,3,36047014000,11228
140,2007,1,5,8,8,16,16,-0.375,-3,-0.6875,-11,-0.6875,-11,36047014000,11228
140,2007,2,7,5,7,18,18,0,0,-0.611111,-11,-0.611111,-11,36047014000,11228
140,2007,3,6,7,20,17,17,-0.7,-14,-0.647059,-11,-0.647059,-11,36047014000,11228
140,2007,4,18,6,16,12,12,0.125,2,0.5,6,0.5,6,36047014000,11228
140,2007,5,15,18,14,8,8,0.071429,1,0.875,7,0.875,7,36047014000,11228
140,2008,0,6,6,8,8,8,-0.25,-2,-0.25,-2,-0.25,-2,36047014000,11228
140,2008,1,9,6,5,6,6,0.8,4,0.5,3,0.5,3,36047014000,11228
140,2008,2,3,9,7,18,18,-0.571429,-4,-0.833333,-15,-0.833333,-15,36047014000,11228
140,2008,3,7,3,6,17,17,0.166667,1,-0.588235,-10,-0.588235,-10,36047014000,11228
140,2008,4,6,7,18,16,16,-0.666667,-12,-0.625,-10,-0.625,-10,36047014000,11228
140,2008,5,19,6,15,12,12,0.266667,4,0.583333,7,0.583333,7,36047014000,11228
140,2009,0,12,12,6,7,7,1,6,0.714286,5,0.714286,5,36047014000,11228
140,2009,1,7,12,9,8,8,-0.222222,-2,-0.125,-1,-0.125,-1,36047014000,11228
140,2009,2,10,7,3,7,7,2.333333,7,0.428571,3,0.428571,3,36047014000,11228
140,2009,3,7,10,7,20,20,0,0,-0.65,-13,-0.65,-13,36047014000,11228
140,2009,4,10,7,6,16,16,0.666667,4,-0.375,-6,-0.375,-6,36047014000,11228
140,2009,5,5,10,19,14,14,-0.736842,-14,-0.642857,-9,-0.642857,-9,36047014000,11228
140,2010,0,8,8,12,8,8,-0.333333,-4,0,0,0,0,36047014000,11228
140,2010,1,13,8,7,5,5,0.857143,6,1.6,8,1.6,8,36047014000,11228
140,2010,2,8,13,10,7,7,-0.2,-2,0.142857,1,0.142857,1,36047014000,11228
140,2010,3,9,8,7,6,6,0.285714,2,0.5,3,0.5,3,36047014000,11228
140,2010,4,6,9,10,18,18,-0.4,-4,-0.666667,-12,-0.666667,-12,36047014000,11228
140,2010,5,10,6,5,15,15,1,5,-0.333333,-5,-0.333333,-5,36047014000,11228
142,2001,0,21,21,21,21,21,0,0,0,0,0,0,36047014200,11209
142,2001,1,32,21,32,32,32,0,0,0,0,0,0,36047014200,11209
142,2001,2,26,32,26,26,26,0,0,0,0,0,0,36047014200,11209
142,2001,3,15,26,15,15,15,0,0,0,0,0,0,36047014200,11209
142,2001,4,12,15,12,12,12,0,0,0,0,0,0,36047014200,11209
142,2001,5,15,12,15,15,15,0,0,0,0,0,0,36047014200,11209
142,2002,0,29,29,21,29,29,0.380952,8,0,0,0,0,36047014200,11209
142,2002,1,20,29,32,20,20,-0.375,-12,0,0,0,0,36047014200,11209
142,2002,2,25,20,26,25,25,-0.038462,-1,0,0,0,0,36047014200,11209
142,2002,3,18,25,15,18,18,0.2,3,0,0,0,0,36047014200,11209
142,2002,4,15,18,12,15,15,0.25,3,0,0,0,0,36047014200,11209
142,2002,5,12,15,15,12,12,-0.2,-3,0,0,0,0,36047014200,11209
142,2003,0,20,20,29,20,20,-0.310345,-9,0,0,0,0,36047014200,11209
142,2003,1,24,20,20,24,24,0.2,4,0,0,0,0,36047014200,11209
142,2003,2,24,24,25,24,24,-0.04,-1,0,0,0,0,36047014200,11209
142,2003,3,21,24,18,21,21,0.166667,3,0,0,0,0,36047014200,11209
142,2003,4,21,21,15,21,21,0.4,6,0,0,0,0,36047014200,11209
142,2003,5,22,21,12,22,22,0.833333,10,0,0,0,0,36047014200,11209
142,2004,0,25,25,20,21,21,0.25,5,0.190476,4,0.190476,4,36047014200,11209
142,2004,1,20,25,24,32,32,-0.166667,-4,-0.375,-12,-0.375,-12,36047014200,11209
142,2004,2,19,20,24,26,26,-0.208333,-5,-0.269231,-7,-0.269231,-7,36047014200,11209
142,2004,3,21,19,21,15,15,0,0,0.4,6,0.4,6,36047014200,11209
142,2004,4,20,21,21,12,12,-0.047619,-1,0.666667,8,0.666667,8,36047014200,11209
142,2004,5,23,20,22,15,15,0.045455,1,0.533333,8,0.533333,8,36047014200,11209
142,2005,0,19,19,25,29,29,-0.24,-6,-0.344828,-10,-0.344828,-10,36047014200,11209
142,2005,1,23,19,20,20,20,0.15,3,0.15,3,0.15,3,36047014200,11209
142,2005,2,19,23,19,25,25,0,0,-0.24,-6,-0.24,-6,36047014200,11209
142,2005,3,17,19,21,18,18,-0.190476,-4,-0.055556,-1,-0.055556,-1,36047014200,11209
142,2005,4,20,17,20,15,15,0,0,0.333333,5,0.333333,5,36047014200,11209
142,2005,5,13,20,23,12,12,-0.434783,-10,0.083333,1,0.083333,1,36047014200,11209
142,2006,0,19,19,19,20,20,0,0,-0.05,-1,-0.05,-1,36047014200,11209
142,2006,1,17,19,23,24,24,-0.26087,-6,-0.291667,-7,-0.291667,-7,36047014200,11209
142,2006,2,22,17,19,24,24,0.157895,3,-0.083333,-2,-0.083333,-2,36047014200,11209
142,2006,3,20,22,17,21,21,0.176471,3,-0.047619,-1,-0.047619,-1,36047014200,11209
142,2006,4,18,20,20,21,21,-0.1,-2,-0.142857,-3,-0.142857,-3,36047014200,11209
142,2006,5,19,18,13,22,22,0.461538,6,-0.136364,-3,-0.136364,-3,36047014200,11209
142,2007,0,23,23,19,25,25,0.210526,4,-0.08,-2,-0.08,-2,36047014200,11209
142,2007,1,23,23,17,20,20,0.352941,6,0.15,3,0.15,3,36047014200,11209
142,2007,2,17,23,22,19,19,-0.227273,-5,-0.105263,-2,-0.105263,-2,36047014200,11209
142,2007,3,18,17,20,21,21,-0.1,-2,-0.142857,-3,-0.142857,-3,36047014200,11209
142,2007,4,19,18,18,20,20,0.055556,1,-0.05,-1,-0.05,-1,36047014200,11209
142,2007,5,20,19,19,23,23,0.052632,1,-0.130435,-3,-0.130435,-3,36047014200,11209
142,2008,0,18,18,23,19,19,-0.217391,-5,-0.052632,-1,-0.052632,-1,36047014200,11209
142,2008,1,26,18,23,23,23,0.130435,3,0.130435,3,0.130435,3,36047014200,11209
142,2008,2,18,26,17,19,19,0.058824,1,-0.052632,-1,-0.052632,-1,36047014200,11209
142,2008,3,16,18,18,17,17,-0.111111,-2,-0.058824,-1,-0.058824,-1,36047014200,11209
142,2008,4,16,16,19,20,20,-0.157895,-3,-0.2,-4,-0.2,-4,36047014200,11209
142,2008,5,14,16,20,13,13,-0.3,-6,0.076923,1,0.076923,1,36047014200,11209
142,2009,0,29,29,18,19,19,0.611111,11,0.526316,10,0.526316,10,36047014200,11209
142,2009,1,17,29,26,17,17,-0.346154,-9,0,0,0,0,36047014200,11209
142,2009,2,26,17,18,22,22,0.444444,8,0.181818,4,0.181818,4,36047014200,11209
142,2009,3,14,26,16,20,20,-0.125,-2,-0.3,-6,-0.3,-6,36047014200,11209
142,2009,4,12,14,16,18,18,-0.25,-4,-0.333333,-6,-0.333333,-6,36047014200,11209
142,2009,5,16,12,14,19,19,0.142857,2,-0.157895,-3,-0.157895,-3,36047014200,11209
142,2010,0,29,29,29,23,23,0,0,0.26087,6,0.26087,6,36047014200,11209
142,2010,1,28,29,17,23,23,0.647059,11,0.217391,5,0.217391,5,36047014200,11209
142,2010,2,20,28,26,17,17,-0.230769,-6,0.176471,3,0.176471,3,36047014200,11209
142,2010,3,26,20,14,18,18,0.857143,12,0.444444,8,0.444444,8,36047014200,11209
142,2010,4,14,26,12,19,19,0.166667,2,-0.263158,-5,-0.263158,-5,36047014200,11209
142,2010,5,12,14,16,20,20,-0.25,-4,-0.4,-8,-0.4,-8,36047014200,11209
148,2001,0,4,4,4,4,4,0,0,0,0,0,0,36047014800,11228
148,2001,1,7,4,7,7,7,0,0,0,0,0,0,36047014800,11228
148,2001,2,9,7,9,9,9,0,0,0,0,0,0,36047014800,11228
148,2001,3,3,9,3,3,3,0,0,0,0,0,0,36047014800,11228
148,2001,4,5,3,5,5,5,0,0,0,0,0,0,36047014800,11228
148,2001,5,6,5,6,6,6,0,0,0,0,0,0,36047014800,11228
148,2002,0,9,9,4,9,9,1.25,5,0,0,0,0,36047014800,11228
148,2002,1,2,9,7,2,2,-0.714286,-5,0,0,0,0,36047014800,11228
148,2002,2,9,2,9,9,9,0,0,0,0,0,0,36047014800,11228
148,2002,3,4,9,3,4,4,0.333333,1,0,0,0,0,36047014800,11228
148,2002,4,4,4,5,4,4,-0.2,-1,0,0,0,0,36047014800,11228
148,2002,5,4,4,6,4,4,-0.333333,-2,0,0,0,0,36047014800,11228
148,2003,0,11,11,9,11,11,0.222222,2,0,0,0,0,36047014800,11228
148,2003,1,7,11,2,7,7,2.5,5,0,0,0,0,36047014800,11228
148,2003,2,3,7,9,3,3,-0.666667,-6,0,0,0,0,36047014800,11228
148,2003,3,7,3,4,7,7,0.75,3,0,0,0,0,36047014800,11228
148,2003,4,3,7,4,3,3,-0.25,-1,0,0,0,0,36047014800,11228
148,2003,5,4,3,4,4,4,0,0,0,0,0,0,36047014800,11228
148,2004,0,11,11,11,4,4,0,0,1.75,7,1.75,7,36047014800,11228
148,2004,1,10,11,7,7,7,0.428571,3,0.428571,3,0.428571,3,36047014800,11228
148,2004,2,7,10,3,9,9,1.333333,4,-0.222222,-2,-0.222222,-2,36047014800,11228
148,2004,3,3,7,7,3,3,-0.571429,-4,0,0,0,0,36047014800,11228
148,2004,4,8,3,3,5,5,1.666667,5,0.6,3,0.6,3,36047014800,11228
148,2004,5,3,8,4,6,6,-0.25,-1,-0.5,-3,-0.5,-3,36047014800,11228
148,2005,0,8,8,11,9,9,-0.272727,-3,-0.111111,-1,-0.111111,-1,36047014800,11228
148,2005,1,11,8,10,2,2,0.1,1,4.5,9,4.5,9,36047014800,11228
148,2005,2,9,11,7,9,9,0.285714,2,0,0,0,0,36047014800,11228
148,2005,3,5,9,3,4,4,0.666667,2,0.25,1,0.25,1,36047014800,11228
148,2005,4,3,5,8,4,4,-0.625,-5,-0.25,-1,-0.25,-1,36047014800,11228
148,2005,5,9,3,3,4,4,2,6,1.25,5,1.25,5,36047014800,11228
148,2006,0,2,2,8,11,11,-0.75,-6,-0.818182,-9,-0.818182,-9,36047014800,11228
148,2006,1,11,2,11,7,7,0,0,0.571429,4,0.571429,4,36047014800,11228
148,2006,2,10,11,9,3,3,0.111111,1,2.333333,7,2.333333,7,36047014800,11228
148,2006,3,9,10,5,7,7,0.8,4,0.285714,2,0.285714,2,36047014800,11228
148,2006,4,6,9,3,3,3,1,3,1,3,1,3,36047014800,11228
148,2006,5,3,6,9,4,4,-0.666667,-6,-0.25,-1,-0.25,-1,36047014800,11228
148,2007,0,7,7,2,11,11,2.5,5,-0.363636,-4,-0.363636,-4,36047014800,11228
148,2007,1,3,7,11,10,10,-0.727273,-8,-0.7,-7,-0.7,-7,36047014800,11228
148,2007,2,11,3,10,7,7,0.1,1,0.571429,4,0.571429,4,36047014800,11228
148,2007,3,12,11,9,3,3,0.333333,3,3,9,3,9,36047014800,11228
148,2007,4,8,12,6,8,8,0.333333,2,0,0,0,0,36047014800,11228
148,2007,5,7,8,3,3,3,1.333333,4,1.333333,4,1.333333,4,36047014800,11228
148,2008,0,7,7,7,8,8,0,0,-0.125,-1,-0.125,-1,36047014800,11228
148,2008,1,6,7,3,11,11,1,3,-0.454545,-5,-0.454545,-5,36047014800,11228
148,2008,2,3,6,11,9,9,-0.727273,-8,-0.666667,-6,-0.666667,-6,36047014800,11228
148,2008,3,11,3,12,5,5,-0.083333,-1,1.2,6,1.2,6,36047014800,11228
148,2008,4,13,11,8,3,3,0.625,5,3.333333,10,3.333333,10,36047014800,11228
148,2008,5,8,13,7,9,9,0.142857,1,-0.111111,-1,-0.111111,-1,36047014800,11228
148,2009,0,9,9,7,2,2,0.285714,2,3.5,7,3.5,7,36047014800,11228
148,2009,1,7,9,6,11,11,0.166667,1,-0.363636,-4,-0.363636,-4,36047014800,11228
148,2009,2,7,7,3,10,10,1.333333,4,-0.3,-3,-0.3,-3,36047014800,11228
148,2009,3,5,7,11,9,9,-0.545455,-6,-0.444444,-4,-0.444444,-4,36047014800,11228
148,2009,4,11,5,13,6,6,-0.153846,-2,0.833333,5,0.833333,5,36047014800,11228
148,2009,5,11,11,8,3,3,0.375,3,2.666667,8,2.666667,8,36047014800,11228
148,2010,0,7,7,9,7,7,-0.222222,-2,0,0,0,0,36047014800,11228
148,2010,1,10,7,7,3,3,0.428571,3,2.333333,7,2.333333,7,36047014800,11228
148,2010,2,7,10,7,11,11,0,0,-0.363636,-4,-0.363636,-4,36047014800,11228
148,2010,3,7,7,5,12,12,0.4,2,-0.416667,-5,-0.416667,-5,36047014800,11228
148,2010,4,5,7,11,8,8,-0.545455,-6,-0.375,-3,-0.375,-3,36047014800,11228
148,2010,5,10,5,11,7,7,-0.090909,-1,0.428571,3,0.428571,3,36047014800,11228
150,2001,0,6,6,6,6,6,0,0,0,0,0,0,36047015000,11228
150,2001,1,5,6,5,5,5,0,0,0,0,0,0,36047015000,11228
150,2001,2,11,5,11,11,11,0,0,0,0,0,0,36047015000,11228
150,2001,3,8,11,8,8,8,0,0,0,0,0,0,36047015000,11228
150,2001,4,4,8,4,4,4,0,0,0,0,0,0,36047015000,11228
150,2001,5,7,4,7,7,7,0,0,0,0,0,0,36047015000,11228
150,2002,0,12,12,6,12,12,1,6,0,0,0,0,36047015000,11228
150,2002,1,5,12,5,5,5,0,0,0,0,0,0,36047015000,11228
150,2002,2,6,5,11,6,6,-0.454545,-5,0,0,0,0,36047015000,11228
150,2002,3,13,6,8,13,13,0.625,5,0,0,0,0,36047015000,11228
150,2002,4,7,13,4,7,7,0.75,3,0,0,0,0,36047015000,11228
150,2002,5,6,7,7,6,6,-0.142857,-1,0,0,0,0,36047015000,11228
150,2003,0,9,9,12,9,9,-0.25,-3,0,0,0,0,36047015000,11228
150,2003,1,11,9,5,11,11,1.2,6,0,0,0,0,36047015000,11228
150,2003,2,4,11,6,4,4,-0.333333,-2,0,0,0,0,36047015000,11228
150,2003,3,8,4,13,8,8,-0.384615,-5,0,0,0,0,36047015000,11228
150,2003,4,9,8,7,9,9,0.285714,2,0,0,0,0,36047015000,11228
150,2003,5,7,9,6,7,7,0.166667,1,0,0,0,0,36047015000,11228
150,2004,0,8,8,9,6,6,-0.111111,-1,0.333333,2,0.333333,2,36047015000,11228
150,2004,1,7,8,11,5,5,-0.363636,-4,0.4,2,0.4,2,36047015000,11228
150,2004,2,10,7,4,11,11,1.5,6,-0.090909,-1,-0.090909,-1,36047015000,11228
150,2004,3,5,10,8,8,8,-0.375,-3,-0.375,-3,-0.375,-3,36047015000,11228
150,2004,4,11,5,9,4,4,0.222222,2,1.75,7,1.75,7,36047015000,11228
150,2004,5,7,11,7,7,7,0,0,0,0,0,0,36047015000,11228
150,2005,0,13,13,8,12,12,0.625,5,0.083333,1,0.083333,1,36047015000,11228
150,2005,1,8,13,7,5,5,0.142857,1,0.6,3,0.6,3,36047015000,11228
150,2005,2,5,8,10,6,6,-0.5,-5,-0.166667,-1,-0.166667,-1,36047015000,11228
150,2005,3,12,5,5,13,13,1.4,7,-0.076923,-1,-0.076923,-1,36047015000,11228
150,2005,4,4,12,11,7,7,-0.636364,-7,-0.428571,-3,-0.428571,-3,36047015000,11228
150,2005,5,8,4,7,6,6,0.142857,1,0.333333,2,0.333333,2,36047015000,11228
150,2006,0,6,6,13,9,9,-0.538462,-7,-0.333333,-3,-0.333333,-3,36047015000,11228
150,2006,1,13,6,8,11,11,0.625,5,0.181818,2,0.181818,2,36047015000,11228
150,2006,2,9,13,5,4,4,0.8,4,1.25,5,1.25,5,36047015000,11228
150,2006,3,6,9,12,8,8,-0.5,-6,-0.25,-2,-0.25,-2,36047015000,11228
150,2006,4,14,6,4,9,9,2.5,10,0.555556,5,0.555556,5,36047015000,11228
150,2006,5,5,14,8,7,7,-0.375,-3,-0.285714,-2,-0.285714,-2,36047015000,11228
150,2007,0,9,9,6,8,8,0.5,3,0.125,1,0.125,1,36047015000,11228
150,2007,1,5,9,13,7,7,-0.615385,-8,-0.285714,-2,-0.285714,-2,36047015000,11228
150,2007,2,14,5,9,10,10,0.555556,5,0.4,4,0.4,4,36047015000,11228
150,2007,3,10,14,6,5,5,0.666667,4,1,5,1,5,36047015000,11228
150,2007,4,7,10,14,11,11,-0.5,-7,-0.363636,-4,-0.363636,-4,36047015000,11228
150,2007,5,13,7,5,7,7,1.6,8,0.857143,6,0.857143,6,36047015000,11228
150,2008,0,8,8,9,13,13,-0.111111,-1,-0.384615,-5,-0.384615,-5,36047015000,11228
150,2008,1,12,8,5,8,8,1.4,7,0.5,4,0.5,4,36047015000,11228
150,2008,2,9,12,14,5,5,-0.357143,-5,0.8,4,0.8,4,36047015000,11228
150,2008,3,14,9,10,12,12,0.4,4,0.166667,2,0.166667,2,36047015000,11228
150,2008,4,12,14,7,4,4,0.714286,5,2,8,2,8,36047015000,11228
150,2008,5,9,12,13,8,8,-0.307692,-4,0.125,1,0.125,1,36047015000,11228
150,2009,0,14,14,8,6,6,0.75,6,1.333333,8,1.333333,8,36047015000,11228
150,2009,1,11,14,12,13,13,-0.083333,-1,-0.153846,-2,-0.153846,-2,36047015000,11228
150,2009,2,12,11,9,9,9,0.333333,3,0.333333,3,0.333333,3,36047015000,11228
150,2009,3,12,12,14,6,6,-0.142857,-2,1,6,1,6,36047015000,11228
150,2009,4,14,12,12,14,14,0.166667,2,0,0,0,0,36047015000,11228
150,2009,5,11,14,9,5,5,0.222222,2,1.2,6,1.2,6,36047015000,11228
150,2010,0,17,17,14,9,9,0.214286,3,0.888889,8,0.888889,8,36047015000,11228
150,2010,1,16,17,11,5,5,0.454545,5,2.2,11,2.2,11,36047015000,11228
150,2010,2,14,16,12,14,14,0.166667,2,0,0,0,0,36047015000,11228
150,2010,3,14,14,12,10,10,0.166667,2,0.4,4,0.4,4,36047015000,11228
150,2010,4,10,14,14,7,7,-0.285714,-4,0.428571,3,0.428571,3,36047015000,11228
150,2010,5,15,10,11,13,13,0.363636,4,0.153846,2,0.153846,2,36047015000,11228
152,2001,0,13,13,13,13,13,0,0,0,0,0,0,,
152,2001,1,12,13,12,12,12,0,0,0,0,0,0,,
152,2001,2,6,12,6,6,6,0,0,0,0,0,0,,
152,2001,3,9,6,9,9,9,0,0,0,0,0,0,,
152,2001,4,8,9,8,8,8,0,0,0,0,0,0,,
152,2001,5,5,8,5,5,5,0,0,0,0,0,0,,
152,2002,0,12,12,13,12,12,-0.076923,-1,0,0,0,0,,
152,2002,1,16,12,12,16,16,0.333333,4,0,0,0,0,,
152,2002,2,7,16,6,7,7,0.166667,1,0,0,0,0,,
152,2002,3,6,7,9,6,6,-0.333333,-3,0,0,0,0,,
152,2002,4,9,6,8,9,9,0.125,1,0,0,0,0,,
152,2002,5,10,9,5,10,10,1,5,0,0,0,0,,
152,2003,0,15,15,12,15,15,0.25,3,0,0,0,0,,
152,2003,1,10,15,16,10,10,-0.375,-6,0,0,0,0,,
152,2003,2,14,10,7,14,14,1,7,0,0,0,0,,
152,2003,3,8,14,6,8,8,0.333333,2,0,0,0,0,,
152,2003,4,4,8,9,4,4,-0.555556,-5,0,0,0,0,,
152,2003,5,8,4,10,8,8,-0.2,-2,0,0,0,0,,
152,2004,0,9,9,15,13,13,-0.4,-6,-0.307692,-4,-0.307692,-4,,
152,2004,1,17,9,10,12,12,0.7,7,0.416667,5,0.416667,5,,
152,2004,2,7,17,14,6,6,-0.5,-7,0.166667,1,0.166667,1,,
152,2004,3,8,7,8,9,9,0,0,-0.111111,-1,-0.111111,-1,,
152,2004,4,6,8,4,8,8,0.5,2,-0.25,-2,-0.25,-2,,
152,2004,5,2,6,8,5,5,-0.75,-6,-0.6,-3,-0.6,-3,,
152,2005,0,11,11,9,12,12,0.222222,2,-0.083333,-1,-0.083333,-1,,
152,2005,1,8,11,17,16,16,-0.529412,-9,-0.5,-8,-0.5,-8,,
152,2005,2,14,8,7,7,7,1,7,1,7,1,7,,
152,2005,3,6,14,8,6,6,-0.25,-2,0,0,0,0,,
152,2005,4,6,6,6,9,9,0,0,-0.333333,-3,-0.333333,-3,,
152,2005,5,2,6,2,10,10,0,0,-0.8,-8,-0.8,-8,,
152,2006,0,9,9,11,15,15,-0.181818,-2,-0.4,-6,-0.4,-6,,
152,2006,1,10,9,8,10,10,0.25,2,0,0,0,0,,
152,2006,2,9,10,14,14,14,-0.357143,-5,-0.357143,-5,-0.357143,-5,,
152,2006,3,10,9,6,8,8,0.666667,4,0.25,2,0.25,2,,
152,2006,4,7,10,6,4,4,0.166667,1,0.75,3,0.75,3,,
152,2006,5,4,7,2,8,8,1,2,-0.5,-4,-0.5,-4,,
152,2007,0,9,9,9,9,9,0,0,0,0,0,0,,
152,2007,1,11,9,10,17,17,0.1,1,-0.352941,-6,-0.352941,-6,,
152,2007,2,8,11,9,7,7,-0.111111,-1,0.142857,1,0.142857,1,,
152,2007,3,8,8,10,8,8,-0.2,-2,0,0,0,0,,
152,2007,4,7,8,7,6,6,0,0,0.166667,1,0.166667,1,,
152,2007,5,7,7,4,2,2,0.75,3,2.5,5,2.5,5,,
152,2008,0,10,10,9,11,11,0.111111,1,-0.090909,-1,-0.090909,-1,,
152,2008,1,6,10,11,8,8,-0.454545,-5,-0.25,-2,-0.25,-2,,
152,2008,2,10,6,8,14,14,0.25,2,-0.285714,-4,-0.285714,-4,,
152,2008,3,6,10,8,6,6,-0.25,-2,0,0,0,0,,
152,2008,4,8,6,7,6,6,0.142857,1,0.333333,2,0.333333,2,,
152,2008,5,7,8,7,2,2,0,0,2.5,5,2.5,5,,
152,2009,0,6,6,10,9,9,-0.4,-4,-0.333333,-3,-0.333333,-3,,
152,2009,1,11,6,6,10,10,0.833333,5,0.1,1,0.1,1,,
152,2009,2,4,11,10,9,9,-0.6,-6,-0.555556,-5,-0.555556,-5,,
152,2009,3,13,4,6,10,10,1.166667,7,0.3,3,0.3,3,,
152,2009,4,7,13,8,7,7,-0.125,-1,0,0,0,0,,
152,2009,5,6,7,7,4,4,-0.142857,-1,0.5,2,0.5,2,,
152,2010,0,17,17,6,9,9,1.833333,11,0.888889,8,0.888889,8,,
152,2010,1,5,17,11,11,11,-0.545455,-6,-0.545455,-6,-0.545455,-6,,
152,2010,2,11,5,4,8,8,1.75,7,0.375,3,0.375,3,,
152,2010,3,4,11,13,8,8,-0.692308,-9,-0.5,-4,-0.5,-4,,
152,2010,4,11,4,7,7,7,0.571429,4,0.571429,4,0.571429,4,,
152,2010,5,4,11,6,7,7,-0.333333,-2,-0.428571,-3,-0.428571,-3,,
160,2001,0,17,17,17,17,17,0,0,0,0,0,0,36047016000,11209
160,2001,1,22,17,22,22,22,0,0,0,0,0,0,36047016000,11209
160,2001,2,14,22,14,14,14,0,0,0,0,0,0,36047016000,11209
160,2001,3,11,14,11,11,11,0,0,0,0,0,0,36047016000,11209
160,2001,4,8,11,8,8,8,0,0,0,0,0,0,36047016000,11209
160,2001,5,11,8,11,11,11,0,0,0,0,0,0,36047016000,11209
160,2002,0,21,21,17,21,21,0.235294,4,0,0,0,0,36047016000,11209
160,2002,1,15,21,22,15,15,-0.318182,-7,0,0,0,0,36047016000,11209
160,2002,2,17,15,14,17,17,0.214286,3,0,0,0,0,36047016000,11209
160,2002,3,14,17,11,14,14,0.272727,3,0,0,0,0,36047016000,11209
160,2002,4,9,14,8,9,9,0.125,1,0,0,0,0,36047016000,11209
160,2002,5,6,9,11,6,6,-0.454545,-5,0,0,0,0,36047016000,11209
160,2003,0,18,18,21,18,18,-0.142857,-3,0,0,0,0,36047016000,11209
160,2003,1,19,18,15,19,19,0.266667,4,0,0,0,0,36047016000,11209
160,2003,2,18,19,17,18,18,0.058824,1,0,0,0,0,36047016000,11209
160,2003,3,18,18,14,18,18,0.285714,4,0,0,0,0,36047016000,11209
160,2003,4,13,18,9,13,13,0.444444,4,0,0,0,0,36047016000,11209
160,2003,5,11,13,6,11,11,0.833333,5,0,0,0,0,36047016000,11209
160,2004,0,23,23,18,17,17,0.277778,5,0.352941,6,0.352941,6,36047016000,11209
160,2004,1,18,23,19,22,22,-0.052632,-1,-0.181818,-4,-0.181818,-4,36047016000,11209
160,2004,2,22,18,18,14,14,0.222222,4,0.571429,8,0.571429,8,36047016000,11209
160,2004,3,20,22,18,11,11,0.111111,2,0.818182,9,0.818182,9,36047016000,11209
160,2004,4,19,20,13,8,8,0.461538,6,1.375,11,1.375,11,36047016000,11209
160,2004,5,12,19,11,11,11,0.090909,1,0.090909,1,0.090909,1,36047016000,11209
160,2005,0,22,22,23,21,21,-0.043478,-1,0.047619,1,0.047619,1,36047016000,11209
160,2005,1,22,22,18,15,15,0.222222,4,0.466667,7,0.466667,7,36047016000,11209
160,2005,2,17,22,22,17,17,-0.227273,-5,0,0,0,0,36047016000,11209
160,2005,3,22,17,20,14,14,0.1,2,0.571429,8,0.571429,8,36047016000,11209
160,2005,4,21,22,19,9,9,0.105263,2,1.333333,12,1.333333,12,36047016000,11209
160,2005,5,18,21,12,6,6,0.5,6,2,12,2,12,36047016000,11209
160,2006,0,23,23,22,18,18,0.045455,1,0.277778,5,0.277778,5,36047016000,11209
160,2006,1,20,23,22,19,19,-0.090909,-2,0.052632,1,0.052632,1,36047016000,11209
160,2006,2,21,20,17,18,18,0.235294,4,0.166667,3,0.166667,3,36047016000,11209
160,2006,3,19,21,22,18,18,-0.136364,-3,0.055556,1,0.055556,1,36047016000,11209
160,2006,4,19,19,21,13,13,-0.095238,-2,0.461538,6,0.461538,6,36047016000,11209
160,2006,5,14,19,18,11,11,-0.222222,-4,0.272727,3,0.272727,3,36047016000,11209
160,2007,0,12,12,23,23,23,-0.478261,-11,-0.478261,-11,-0.478261,-11,36047016000,11209
160,2007,1,22,12,20,18,18,0.1,2,0.222222,4,0.222222,4,36047016000,11209
160,2007,2,14,22,21,22,22,-0.333333,-7,-0.363636,-8,-0.363636,-8,36047016000,11209
160,2007,3,20,14,19,20,20,0.052632,1,0,0,0,0,36047016000,11209
160,2007,4,15,20,19,19,19,-0.210526,-4,-0.210526,-4,-0.210526,-4,36047016000,11209
160,2007,5,15,15,14,12,12,0.071429,1,0.25,3,0.25,3,36047016000,11209
160,2008,0,38,38,12,22,22,2.166667,26,0.727273,16,0.727273,16,36047016000,11209
160,2008,1,10,38,22,22,22,-0.545455,-12,-0.545455,-12,-0.545455,-12,36047016000,11209
160,2008,2,20,10,14,17,17,0.428571,6,0.176471,3,0.176471,3,36047016000,11209
160,2008,3,12,20,20,22,22,-0.4,-8,-0.454545,-10,-0.454545,-10,36047016000,11209
160,2008,4,12,12,15,21,21,-0.2,-3,-0.428571,-9,-0.428571,-9,36047016000,11209
160,2008,5,10,12,15,18,18,-0.333333,-5,-0.444444,-8,-0.444444,-8,36047016000,11209
160,2009,0,22,22,38,23,23,-0.421053,-16,-0.043478,-1,-0.043478,-1,36047016000,11209
160,2009,1,44,22,10,20,20,3.4,34,1.2,24,1.2,24,36047016000,11209
160,2009,2,12,44,20,21,21,-0.4,-8,-0.428571,-9,-0.428571,-9,36047016000,11209
160,2009,3,17,12,12,19,19,0.416667,5,-0.105263,-2,-0.105263,-2,36047016000,11209
160,2009,4,9,17,12,19,19,-0.25,-3,-0.526316,-10,-0.526316,-10,36047016000,11209
160,2009,5,7,9,10,14,14,-0.3,-3,-0.5,-7,-0.5,-7,36047016000,11209
160,2010,0,28,28,22,12,12,0.272727,6,1.333333,16,1.333333,16,36047016000,11209
160,2010,1,19,28,44,22,22,-0.568182,-25,-0.136364,-3,-0.136364,-3,36047016000,11209
160,2010,2,45,19,12,14,14,2.75,33,2.214286,31,2.214286,31,36047016000,11209
160,2010,3,13,45,17,20,20,-0.235294,-4,-0.35,-7,-0.35,-7,36047016000,11209
160,2010,4,13,13,9,15,15,0.444444,4,-0.133333,-2,-0.133333,-2,36047016000,11209
160,2010,5,10,13,7,15,15,0.428571,3,-0.333333,-5,-0.333333,-5,36047016000,11209
162,2001,0,4,4,4,4,4,0,0,0,0,0,0,36047016200,11209
162,2001,1,6,4,6,6,6,0,0,0,0,0,0,36047016200,11209
162,2001,2,5,6,5,5,5,0,0,0,0,0,0,36047016200,11209
162,2001,3,3,5,3,3,3,0,0,0,0,0,0,36047016200,11209
162,2001,4,3,3,3,3,3,0,0,0,0,0,0,36047016200,11209
162,2001,5,2,3,2,2,2,0,0,0,0,0,0,36047016200,11209
162,2002,0,5,5,4,5,5,0.25,1,0,0,0,0,36047016200,11209
162,2002,1,6,5,6,6,6,0,0,0,0,0,0,36047016200,11209
162,2002,2,6,6,5,6,6,0.2,1,0,0,0,0,36047016200,11209
162,2002,3,6,6,3,6,6,1,3,0,0,0,0,36047016200,11209
162,2002,4,4,6,3,4,4,0.333333,1,0,0,0,0,36047016200,11209
162,2002,5,3,4,2,3,3,0.5,1,0,0,0,0,36047016200,11209
162,2003,0,8,8,5,8,8,0.6,3,0,0,0,0,36047016200,11209
162,2003,1,5,8,6,5,5,-0.166667,-1,0,0,0,0,36047016200,11209
162,2003,2,6,5,6,6,6,0,0,0,0,0,0,36047016200,11209
162,2003,3,5,6,6,5,5,-0.166667,-1,0,0,0,0,36047016200,11209
162,2003,4,5,5,4,5,5,0.25,1,0,0,0,0,36047016200,11209
162,2003,5,5,5,3,5,5,0.666667,2,0,0,0,0,36047016200,11209
162,2004,0,10,10,8,4,4,0.25,2,1.5,6,1.5,6,36047016200,11209
162,2004,1,6,10,5,6,6,0.2,1,0,0,0,0,36047016200,11209
162,2004,2,6,6,6,5,5,0,0,0.2,1,0.2,1,36047016200,11209
162,2004,3,3,6,5,3,3,-0.4,-2,0,0,0,0,36047016200,11209
162,2004,4,4,3,5,3,3,-0.2,-1,0.333333,1,0.333333,1,36047016200,11209
162,2004,5,4,4,5,2,2,-0.2,-1,1,2,1,2,36047016200,11209
162,2005,0,13,13,10,5,5,0.3,3,1.6,8,1.6,8,36047016200,11209
162,2005,1,10,13,6,6,6,0.666667,4,0.666667,4,0.666667,4,36047016200,11209
162,2005,2,6,10,6,6,6,0,0,0,0,0,0,36047016200,11209
162,2005,3,7,6,3,6,6,1.333333,4,0.166667,1,0.166667,1,36047016200,11209
162,2005,4,3,7,4,4,4,-0.25,-1,-0.25,-1,-0.25,-1,36047016200,11209
162,2005,5,6,3,4,3,3,0.5,2,1,3,1,3,36047016200,11209
162,2006,0,7,7,13,8,8,-0.461538,-6,-0.125,-1,-0.125,-1,36047016200,11209
162,2006,1,11,7,10,5,5,0.1,1,1.2,6,1.2,6,36047016200,11209
162,2006,2,5,11,6,6,6,-0.166667,-1,-0.166667,-1,-0.166667,-1,36047016200,11209
162,2006,3,2,5,7,5,5,-0.714286,-5,-0.6,-3,-0.6,-3,36047016200,11209
162,2006,4,5,2,3,5,5,0.666667,2,0,0,0,0,36047016200,11209
162,2006,5,3,5,6,5,5,-0.5,-3,-0.4,-2,-0.4,-2,36047016200,11209
162,2007,0,3,3,7,10,10,-0.571429,-4,-0.7,-7,-0.7,-7,36047016200,11209
162,2007,1,8,3,11,6,6,-0.272727,-3,0.333333,2,0.333333,2,36047016200,11209
162,2007,2,9,8,5,6,6,0.8,4,0.5,3,0.5,3,36047016200,11209
162,2007,3,3,9,2,3,3,0.5,1,0,0,0,0,36047016200,11209
162,2007,4,1,3,5,4,4,-0.8,-4,-0.75,-3,-0.75,-3,36047016200,11209
162,2007,5,6,1,3,4,4,1,3,0.5,2,0.5,2,36047016200,11209
162,2008,0,10,10,3,13,13,2.333333,7,-0.230769,-3,-0.230769,-3,36047016200,11209
162,2008,1,5,10,8,10,10,-0.375,-3,-0.5,-5,-0.5,-5,36047016200,11209
162,2008,2,4,5,9,6,6,-0.555556,-5,-0.333333,-2,-0.333333,-2,36047016200,11209
162,2008,3,7,4,3,7,7,1.333333,4,0,0,0,0,36047016200,11209
162,2008,4,3,7,1,3,3,2,2,0,0,0,0,36047016200,11209
162,2008,5,1,3,6,6,6,-0.833333,-5,-0.833333,-5,-0.833333,-5,36047016200,11209
162,2009,0,6,6,10,7,7,-0.4,-4,-0.142857,-1,-0.142857,-1,36047016200,11209
162,2009,1,13,6,5,11,11,1.6,8,0.181818,2,0.181818,2,36047016200,11209
162,2009,2,5,13,4,5,5,0.25,1,0,0,0,0,36047016200,11209
162,2009,3,3,5,7,2,2,-0.571429,-4,0.5,1,0.5,1,36047016200,11209
162,2009,4,7,3,3,5,5,1.333333,4,0.4,2,0.4,2,36047016200,11209
162,2009,5,1,7,1,3,3,0,0,-0.666667,-2,-0.666667,-2,36047016200,11209
162,2010,0,10,10,6,3,3,0.666667,4,2.333333,7,2.333333,7,36047016200,11209
162,2010,1,5,10,13,8,8,-0.615385,-8,-0.375,-3,-0.375,-3,36047016200,11209
162,2010,2,13,5,5,9,9,1.6,8,0.444444,4,0.444444,4,36047016200,11209
162,2010,3,3,13,3,3,3,0,0,0,0,0,0,36047016200,11209
162,2010,4,3,3,7,1,1,-0.571429,-4,2,2,2,2,36047016200,11209
162,2010,5,4,3,1,6,6,3,3,-0.333333,-2,-0.333333,-2,36047016200,11209
164,2001,0,2,2,2,2,2,0,0,0,0,0,0,36047016400,11209
164,2001,1,7,2,7,7,7,0,0,0,0,0,0,36047016400,11209
164,2001,2,7,7,7,7,7,0,0,0,0,0,0,36047016400,11209
164,2001,3,4,7,4,4,4,0,0,0,0,0,0,36047016400,11209
164,2001,4,10,4,10,10,10,0,0,0,0,0,0,36047016400,11209
164,2001,5,4,10,4,4,4,0,0,0,0,0,0,36047016400,11209
164,2002,0,1,1,2,1,1,-0.5,-1,0,0,0,0,36047016400,11209
164,2002,1,5,1,7,5,5,-0.285714,-2,0,0,0,0,36047016400,11209
164,2002,2,7,5,7,7,7,0,0,0,0,0,0,36047016400,11209
164,2002,3,9,7,4,9,9,1.25,5,0,0,0,0,36047016400,11209
164,2002,4,3,9,10,3,3,-0.7,-7,0,0,0,0,36047016400,11209
164,2002,5,5,3,4,5,5,0.25,1,0,0,0,0,36047016400,11209
164,2003,1,1,0,5,1,1,-0.8,-4,0,0,0,0,36047016400,11209
164,2003,2,4,1,7,4,4,-0.428571,-3,0,0,0,0,36047016400,11209
164,2003,3,6,4,9,6,6,-0.333333,-3,0,0,0,0,36047016400,11209
164,2003,4,4,6,3,4,4,0.333333,1,0,0,0,0,36047016400,11209
164,2003,5,2,4,5,2,2,-0.6,-3,0,0,0,0,36047016400,11209
164,2004,0,4,4,2,2,2,1,2,1,2,1,2,36047016400,11209
164,2004,2,1,0,4,7,7,-0.75,-3,-0.857143,-6,-0.857143,-6,36047016400,11209
164,2004,3,1,1,6,4,4,-0.833333,-5,-0.75,-3,-0.75,-3,36047016400,11209
164,2004,4,4,1,4,10,10,0,0,-0.6,-6,-0.6,-6,36047016400,11209
164,2004,5,3,4,2,4,4,0.5,1,-0.25,-1,-0.25,-1,36047016400,11209
164,2005,0,2,2,4,1,1,-0.5,-2,1,1,1,1,36047016400,11209
164,2005,1,7,2,5,5,5,0.4,2,0.4,2,0.4,2,36047016400,11209
164,2005,2,1,7,1,7,7,0,0,-0.857143,-6,-0.857143,-6,36047016400,11209
164,2005,3,2,1,1,9,9,1,1,-0.777778,-7,-0.777778,-7,36047016400,11209
164,2005,4,2,2,4,3,3,-0.5,-2,-0.333333,-1,-0.333333,-1,36047016400,11209
164,2005,5,2,2,3,5,5,-0.333333,-1,-0.6,-3,-0.6,-3,36047016400,11209
164,2006,0,12,12,2,0,0,5,10,1,12,1,12,36047016400,11209
164,2006,1,4,12,7,1,1,-0.428571,-3,3,3,3,3,36047016400,11209
164,2006,2,5,4,1,4,4,4,4,0.25,1,0.25,1,36047016400,11209
164,2006,3,3,5,2,6,6,0.5,1,-0.5,-3,-0.5,-3,36047016400,11209
164,2006,4,3,3,2,4,4,0.5,1,-0.25,-1,-0.25,-1,36047016400,11209
164,2006,5,2,3,2,2,2,0,0,0,0,0,0,36047016400,11209
164,2007,0,8,8,12,4,4,-0.333333,-4,1,4,1,4,36047016400,11209
164,2007,1,9,8,4,0,0,1.25,5,1,9,1,9,36047016400,11209
164,2007,2,6,9,5,1,1,0.2,1,5,5,5,5,36047016400,11209
164,2007,3,4,6,3,1,1,0.333333,1,3,3,3,3,36047016400,11209
164,2007,5,5,0,2,3,3,1.5,3,0.666667,2,0.666667,2,36047016400,11209
164,2008,0,11,11,8,2,2,0.375,3,4.5,9,4.5,9,36047016400,11209
164,2008,1,8,11,9,7,7,-0.111111,-1,0.142857,1,0.142857,1,36047016400,11209
164,2008,2,8,8,6,1,1,0.333333,2,7,7,7,7,36047016400,11209
164,2008,3,6,8,4,2,2,0.5,2,2,4,2,4,36047016400,11209
164,2008,4,2,6,2,2,2,0,0,0,0,0,0,36047016400,11209
164,2008,5,1,2,5,2,2,-0.8,-4,-0.5,-1,-0.5,-1,36047016400,11209
164,2009,0,13,13,11,12,12,0.181818,2,0.083333,1,0.083333,1,36047016400,11209
164,2009,1,9,13,8,4,4,0.125,1,1.25,5,1.25,5,36047016400,11209
164,2009,2,6,9,8,5,5,-0.25,-2,0.2,1,0.2,1,36047016400,11209
164,2009,3,6,6,6,3,3,0,0,1,3,1,3,36047016400,11209
164,2009,4,4,6,2,3,3,1,2,0.333333,1,0.333333,1,36047016400,11209
164,2010,0,24,24,13,8,8,0.846154,11,2,16,2,16,36047016400,11209
164,2010,1,17,24,9,9,9,0.888889,8,0.888889,8,0.888889,8,36047016400,11209
164,2010,2,21,17,6,6,6,2.5,15,2.5,15,2.5,15,36047016400,11209
164,2010,3,10,21,6,4,4,0.666667,4,1.5,6,1.5,6,36047016400,11209
164,2010,4,9,10,4,0,0,1.25,5,1,9,1,9,36047016400,11209
164,2010,5,4,9,5,5,5,-0.2,-1,-0.2,-1,-0.2,-1,36047016400,11209
166,2001,0,9,9,9,9,9,0,0,0,0,0,0,,
166,2001,1,8,9,8,8,8,0,0,0,0,0,0,,
166,2001,2,12,8,12,12,12,0,0,0,0,0,0,,
166,2001,3,7,12,7,7,7,0,0,0,0,0,0,,
166,2001,4,6,7,6,6,6,0,0,0,0,0,0,,
166,2001,5,9,6,9,9,9,0,0,0,0,0,0,,
166,2002,0,7,7,9,7,7,-0.222222,-2,0,0,0,0,,
166,2002,1,7,7,8,7,7,-0.125,-1,0,0,0,0,,
166,2002,2,11,7,12,11,11,-0.083333,-1,0,0,0,0,,
166,2002,3,15,11,7,15,15,1.142857,8,0,0,0,0,,
166,2002,4,8,15,6,8,8,0.333333,2,0,0,0,0,,
166,2002,5,8,8,9,8,8,-0.111111,-1,0,0,0,0,,
166,2003,0,3,3,7,3,3,-0.571429,-4,0,0,0,0,,
166,2003,1,7,3,7,7,7,0,0,0,0,0,0,,
166,2003,2,7,7,11,7,7,-0.363636,-4,0,0,0,0,,
166,2003,3,11,7,15,11,11,-0.266667,-4,0,0,0,0,,
166,2003,4,13,11,8,13,13,0.625,5,0,0,0,0,,
166,2003,5,9,13,8,9,9,0.125,1,0,0,0,0,,
166,2004,0,9,9,3,9,9,2,6,0,0,0,0,,
166,2004,1,5,9,7,8,8,-0.285714,-2,-0.375,-3,-0.375,-3,,
166,2004,2,4,5,7,12,12,-0.428571,-3,-0.666667,-8,-0.666667,-8,,
166,2004,3,8,4,11,7,7,-0.272727,-3,0.142857,1,0.142857,1,,
166,2004,4,13,8,13,6,6,0,0,1.166667,7,1.166667,7,,
166,2004,5,13,13,9,9,9,0.444444,4,0.444444,4,0.444444,4,,
166,2005,0,7,7,9,7,7,-0.222222,-2,0,0,0,0,,
166,2005,1,9,7,5,7,7,0.8,4,0.285714,2,0.285714,2,,
166,2005,2,6,9,4,11,11,0.5,2,-0.454545,-5,-0.454545,-5,,
166,2005,3,4,6,8,15,15,-0.5,-4,-0.733333,-11,-0.733333,-11,,
166,2005,4,7,4,13,8,8,-0.461538,-6,-0.125,-1,-0.125,-1,,
166,2005,5,13,7,13,8,8,0,0,0.625,5,0.625,5,,
166,2006,0,2,2,7,3,3,-0.714286,-5,-0.333333,-1,-0.333333,-1,,
166,2006,1,5,2,9,7,7,-0.444444,-4,-0.285714,-2,-0.285714,-2,,
166,2006,2,8,5,6,7,7,0.333333,2,0.142857,1,0.142857,1,,
166,2006,3,4,8,4,11,11,0,0,-0.636364,-7,-0.636364,-7,,
166,2006,4,4,4,7,13,13,-0.428571,-3,-0.692308,-9,-0.692308,-9,,
166,2006,5,10,4,13,9,9,-0.230769,-3,0.111111,1,0.111111,1,,
166,2007,0,3,3,2,9,9,0.5,1,-0.666667,-6,-0.666667,-6,,
166,2007,1,3,3,5,5,5,-0.4,-2,-0.4,-2,-0.4,-2,,
166,2007,2,4,3,8,4,4,-0.5,-4,0,0,0,0,,
166,2007,3,7,4,4,8,8,0.75,3,-0.125,-1,-0.125,-1,,
166,2007,4,6,7,4,13,13,0.5,2,-0.538462,-7,-0.538462,-7,,
166,2007,5,4,6,10,13,13,-0.6,-6,-0.692308,-9,-0.692308,-9,,
166,2008,0,6,6,3,7,7,1,3,-0.142857,-1,-0.142857,-1,,
166,2008,1,3,6,3,9,9,0,0,-0.666667,-6,-0.666667,-6,,
166,2008,2,2,3,4,6,6,-0.5,-2,-0.666667,-4,-0.666667,-4,,
166,2008,3,5,2,7,4,4,-0.285714,-2,0.25,1,0.25,1,,
166,2008,4,8,5,6,7,7,0.333333,2,0.142857,1,0.142857,1,,
166,2008,5,5,8,4,13,13,0.25,1,-0.615385,-8,-0.615385,-8,,
166,2009,0,5,5,6,2,2,-0.166667,-1,1.5,3,1.5,3,,
166,2009,1,6,5,3,5,5,1,3,0.2,1,0.2,1,,
166,2009,2,3,6,2,8,8,0.5,1,-0.625,-5,-0.625,-5,,
166,2009,3,3,3,5,4,4,-0.4,-2,-0.25,-1,-0.25,-1,,
166,2009,4,5,3,8,4,4,-0.375,-3,0.25,1,0.25,1,,
166,2009,5,8,5,5,10,10,0.6,3,-0.2,-2,-0.2,-2,,
166,2010,0,5,5,5,3,3,0,0,0.666667,2,0.666667,2,,
166,2010,1,7,5,6,3,3,0.166667,1,1.333333,4,1.333333,4,,
166,2010,2,7,7,3,4,4,1.333333,4,0.75,3,0.75,3,,
166,2010,3,4,7,3,7,7,0.333333,1,-0.428571,-3,-0.428571,-3,,
166,2010,4,4,4,5,6,6,-0.2,-1,-0.333333,-2,-0.333333,-2,,
166,2010,5,6,4,8,4,4,-0.25,-2,0.5,2,0.5,2,,
168,2001,0,9,9,9,9,9,0,0,0,0,0,0,36047016800,11214
168,2001,1,11,9,11,11,11,0,0,0,0,0,0,36047016800,11214
168,2001,2,4,11,4,4,4,0,0,0,0,0,0,36047016800,11214
168,2001,3,3,4,3,3,3,0,0,0,0,0,0,36047016800,11214
168,2001,4,5,3,5,5,5,0,0,0,0,0,0,36047016800,11214
168,2001,5,11,5,11,11,11,0,0,0,0,0,0,36047016800,11214
168,2002,0,14,14,9,14,14,0.555556,5,0,0,0,0,36047016800,11214
168,2002,1,6,14,11,6,6,-0.454545,-5,0,0,0,0,36047016800,11214
168,2002,2,11,6,4,11,11,1.75,7,0,0,0,0,36047016800,11214
168,2002,3,4,11,3,4,4,0.333333,1,0,0,0,0,36047016800,11214
168,2002,4,4,4,5,4,4,-0.2,-1,0,0,0,0,36047016800,11214
168,2002,5,6,4,11,6,6,-0.454545,-5,0,0,0,0,36047016800,11214
168,2003,0,14,14,14,14,14,0,0,0,0,0,0,36047016800,11214
168,2003,1,14,14,6,14,14,1.333333,8,0,0,0,0,36047016800,11214
168,2003,2,6,14,11,6,6,-0.454545,-5,0,0,0,0,36047016800,11214
168,2003,3,14,6,4,14,14,2.5,10,0,0,0,0,36047016800,11214
168,2003,4,4,14,4,4,4,0,0,0,0,0,0,36047016800,11214
168,2003,5,5,4,6,5,5,-0.166667,-1,0,0,0,0,36047016800,11214
168,2004,0,6,6,14,9,9,-0.571429,-8,-0.333333,-3,-0.333333,-3,36047016800,11214
168,2004,1,9,6,14,11,11,-0.357143,-5,-0.181818,-2,-0.181818,-2,36047016800,11214
168,2004,2,17,9,6,4,4,1.833333,11,3.25,13,3.25,13,36047016800,11214
168,2004,3,9,17,14,3,3,-0.357143,-5,2,6,2,6,36047016800,11214
168,2004,4,15,9,4,5,5,2.75,11,2,10,2,10,36047016800,11214
168,2004,5,5,15,5,11,11,0,0,-0.545455,-6,-0.545455,-6,36047016800,11214
168,2005,0,9,9,6,14,14,0.5,3,-0.357143,-5,-0.357143,-5,36047016800,11214
168,2005,1,6,9,9,6,6,-0.333333,-3,0,0,0,0,36047016800,11214
168,2005,2,8,6,17,11,11,-0.529412,-9,-0.272727,-3,-0.272727,-3,36047016800,11214
168,2005,3,17,8,9,4,4,0.888889,8,3.25,13,3.25,13,36047016800,11214
168,2005,4,6,17,15,4,4,-0.6,-9,0.5,2,0.5,2,36047016800,11214
168,2005,5,15,6,5,6,6,2,10,1.5,9,1.5,9,36047016800,11214
168,2006,0,13,13,9,14,14,0.444444,4,-0.071429,-1,-0.071429,-1,36047016800,11214
168,2006,1,10,13,6,14,14,0.666667,4,-0.285714,-4,-0.285714,-4,36047016800,11214
168,2006,2,5,10,8,6,6,-0.375,-3,-0.166667,-1,-0.166667,-1,36047016800,11214
168,2006,3,7,5,17,14,14,-0.588235,-10,-0.5,-7,-0.5,-7,36047016800,11214
168,2006,4,16,7,6,4,4,1.666667,10,3,12,3,12,36047016800,11214
168,2006,5,6,16,15,5,5,-0.6,-9,0.2,1,0.2,1,36047016800,11214
168,2007,0,5,5,13,6,6,-0.615385,-8,-0.166667,-1,-0.166667,-1,36047016800,11214
168,2007,1,13,5,10,9,9,0.3,3,0.444444,4,0.444444,4,36047016800,11214
168,2007,2,8,13,5,17,17,0.6,3,-0.529412,-9,-0.529412,-9,36047016800,11214
168,2007,3,6,8,7,9,9,-0.142857,-1,-0.333333,-3,-0.333333,-3,36047016800,11214
168,2007,4,6,6,16,15,15,-0.625,-10,-0.6,-9,-0.6,-9,36047016800,11214
168,2007,5,16,6,6,5,5,1.666667,10,2.2,11,2.2,11,36047016800,11214
168,2008,0,18,18,5,9,9,2.6,13,1,9,1,9,36047016800,11214
168,2008,1,4,18,13,6,6,-0.692308,-9,-0.333333,-2,-0.333333,-2,36047016800,11214
168,2008,2,11,4,8,8,8,0.375,3,0.375,3,0.375,3,36047016800,11214
168,2008,3,9,11,6,17,17,0.5,3,-0.470588,-8,-0.470588,-8,36047016800,11214
168,2008,4,5,9,6,6,6,-0.166667,-1,-0.166667,-1,-0.166667,-1,36047016800,11214
168,2008,5,6,5,16,15,15,-0.625,-10,-0.6,-9,-0.6,-9,36047016800,11214
168,2009,0,7,7,18,13,13,-0.611111,-11,-0.461538,-6,-0.461538,-6,36047016800,11214
168,2009,1,24,7,4,10,10,5,20,1.4,14,1.4,14,36047016800,11214
168,2009,2,4,24,11,5,5,-0.636364,-7,-0.2,-1,-0.2,-1,36047016800,11214
168,2009,3,11,4,9,7,7,0.222222,2,0.571429,4,0.571429,4,36047016800,11214
168,2009,4,8,11,5,16,16,0.6,3,-0.5,-8,-0.5,-8,36047016800,11214
168,2009,5,7,8,6,6,6,0.166667,1,0.166667,1,0.166667,1,36047016800,11214
168,2010,0,10,10,7,5,5,0.428571,3,1,5,1,5,36047016800,11214
168,2010,1,10,10,24,13,13,-0.583333,-14,-0.230769,-3,-0.230769,-3,36047016800,11214
168,2010,2,21,10,4,8,8,4.25,17,1.625,13,1.625,13,36047016800,11214
168,2010,3,6,21,11,6,6,-0.454545,-5,0,0,0,0,36047016800,11214
168,2010,4,12,6,8,6,6,0.5,4,1,6,1,6,36047016800,11214
168,2010,5,8,12,7,16,16,0.142857,1,-0.5,-8,-0.5,-8,36047016800,11214
170,2001,0,28,28,28,28,28,0,0,0,0,0,0,36047017000,11228
170,2001,1,30,28,30,30,30,0,0,0,0,0,0,36047017000,11228
170,2001,2,29,30,29,29,29,0,0,0,0,0,0,36047017000,11228
170,2001,3,19,29,19,19,19,0,0,0,0,0,0,36047017000,11228
170,2001,4,27,19,27,27,27,0,0,0,0,0,0,36047017000,11228
170,2001,5,35,27,35,35,35,0,0,0,0,0,0,36047017000,11228
170,2002,0,30,30,28,30,30,0.071429,2,0,0,0,0,36047017000,11228
170,2002,1,33,30,30,33,33,0.1,3,0,0,0,0,36047017000,11228
170,2002,2,29,33,29,29,29,0,0,0,0,0,0,36047017000,11228
170,2002,3,30,29,19,30,30,0.578947,11,0,0,0,0,36047017000,11228
170,2002,4,23,30,27,23,23,-0.148148,-4,0,0,0,0,36047017000,11228
170,2002,5,27,23,35,27,27,-0.228571,-8,0,0,0,0,36047017000,11228
170,2003,0,30,30,30,30,30,0,0,0,0,0,0,36047017000,11228
170,2003,1,29,30,33,29,29,-0.121212,-4,0,0,0,0,36047017000,11228
170,2003,2,34,29,29,34,34,0.172414,5,0,0,0,0,36047017000,11228
170,2003,3,32,34,30,32,32,0.066667,2,0,0,0,0,36047017000,11228
170,2003,4,30,32,23,30,30,0.304348,7,0,0,0,0,36047017000,11228
170,2003,5,24,30,27,24,24,-0.111111,-3,0,0,0,0,36047017000,11228
170,2004,0,19,19,30,28,28,-0.366667,-11,-0.321429,-9,-0.321429,-9,36047017000,11228
170,2004,1,32,19,29,30,30,0.103448,3,0.066667,2,0.066667,2,36047017000,11228
170,2004,2,29,32,34,29,29,-0.147059,-5,0,0,0,0,36047017000,11228
170,2004,3,37,29,32,19,19,0.15625,5,0.947368,18,0.947368,18,36047017000,11228
170,2004,4,27,37,30,27,27,-0.1,-3,0,0,0,0,36047017000,11228
170,2004,5,32,27,24,35,35,0.333333,8,-0.085714,-3,-0.085714,-3,36047017000,11228
170,2005,0,28,28,19,30,30,0.473684,9,-0.066667,-2,-0.066667,-2,36047017000,11228
170,2005,1,19,28,32,33,33,-0.40625,-13,-0.424242,-14,-0.424242,-14,36047017000,11228
170,2005,2,33,19,29,29,29,0.137931,4,0.137931,4,0.137931,4,36047017000,11228
170,2005,3,33,33,37,30,30,-0.108108,-4,0.1,3,0.1,3,36047017000,11228
170,2005,4,39,33,27,23,23,0.444444,12,0.695652,16,0.695652,16,36047017000,11228
170,2005,5,32,39,32,27,27,0,0,0.185185,5,0.185185,5,36047017000,11228
170,2006,0,16,16,28,30,30,-0.428571,-12,-0.466667,-14,-0.466667,-14,36047017000,11228
170,2006,1,28,16,19,29,29,0.473684,9,-0.034483,-1,-0.034483,-1,36047017000,11228
170,2006,2,19,28,33,34,34,-0.424242,-14,-0.441176,-15,-0.441176,-15,36047017000,11228
170,2006,3,38,19,33,32,32,0.151515,5,0.1875,6,0.1875,6,36047017000,11228
170,2006,4,35,38,39,30,30,-0.102564,-4,0.166667,5,0.166667,5,36047017000,11228
170,2006,5,44,35,32,24,24,0.375,12,0.833333,20,0.833333,20,36047017000,11228
170,2007,0,14,14,16,19,19,-0.125,-2,-0.263158,-5,-0.263158,-5,36047017000,11228
170,2007,1,14,14,28,32,32,-0.5,-14,-0.5625,-18,-0.5625,-18,36047017000,11228
170,2007,2,28,14,19,29,29,0.473684,9,-0.034483,-1,-0.034483,-1,36047017000,11228
170,2007,3,15,28,38,37,37,-0.605263,-23,-0.594595,-22,-0.594595,-22,36047017000,11228
170,2007,4,37,15,35,27,27,0.057143,2,0.37037,10,0.37037,10,36047017000,11228
170,2007,5,34,37,44,32,32,-0.227273,-10,0.0625,2,0.0625,2,36047017000,11228
170,2008,0,32,32,14,28,28,1.285714,18,0.142857,4,0.142857,4,36047017000,11228
170,2008,1,20,32,14,19,19,0.428571,6,0.052632,1,0.052632,1,36047017000,11228
170,2008,2,12,20,28,33,33,-0.571429,-16,-0.636364,-21,-0.636364,-21,36047017000,11228
170,2008,3,29,12,15,33,33,0.933333,14,-0.121212,-4,-0.121212,-4,36047017000,11228
170,2008,4,16,29,37,39,39,-0.567568,-21,-0.589744,-23,-0.589744,-23,36047017000,11228
170,2008,5,40,16,34,32,32,0.176471,6,0.25,8,0.25,8,36047017000,11228
170,2009,0,23,23,32,16,16,-0.28125,-9,0.4375,7,0.4375,7,36047017000,11228
170,2009,1,42,23,20,28,28,1.1,22,0.5,14,0.5,14,36047017000,11228
170,2009,2,31,42,12,19,19,1.583333,19,0.631579,12,0.631579,12,36047017000,11228
170,2009,3,17,31,29,38,38,-0.413793,-12,-0.552632,-21,-0.552632,-21,36047017000,11228
170,2009,4,26,17,16,35,35,0.625,10,-0.257143,-9,-0.257143,-9,36047017000,11228
170,2009,5,27,26,40,44,44,-0.325,-13,-0.386364,-17,-0.386364,-17,36047017000,11228
170,2010,0,43,43,23,14,14,0.869565,20,2.071429,29,2.071429,29,36047017000,11228
170,2010,1,24,43,42,14,14,-0.428571,-18,0.714286,10,0.714286,10,36047017000,11228
170,2010,2,40,24,31,28,28,0.290323,9,0.428571,12,0.428571,12,36047017000,11228
170,2010,3,25,40,17,15,15,0.470588,8,0.666667,10,0.666667,10,36047017000,11228
170,2010,4,18,25,26,37,37,-0.307692,-8,-0.513514,-19,-0.513514,-19,36047017000,11228
170,2010,5,25,18,27,34,34,-0.074074,-2,-0.264706,-9,-0.264706,-9,36047017000,11228
172,2001,0,25,25,25,25,25,0,0,0,0,0,0,36047017200,11214
172,2001,1,19,25,19,19,19,0,0,0,0,0,0,36047017200,11214
172,2001,2,20,19,20,20,20,0,0,0,0,0,0,36047017200,11214
172,2001,3,25,20,25,25,25,0,0,0,0,0,0,36047017200,11214
172,2001,4,23,25,23,23,23,0,0,0,0,0,0,36047017200,11214
172,2001,5,29,23,29,29,29,0,0,0,0,0,0,36047017200,11214
172,2002,0,31,31,25,31,31,0.24,6,0,0,0,0,36047017200,11214
172,2002,1,25,31,19,25,25,0.315789,6,0,0,0,0,36047017200,11214
172,2002,2,21,25,20,21,21,0.05,1,0,0,0,0,36047017200,11214
172,2002,3,25,21,25,25,25,0,0,0,0,0,0,36047017200,11214
172,2002,4,24,25,23,24,24,0.043478,1,0,0,0,0,36047017200,11214
172,2002,5,24,24,29,24,24,-0.172414,-5,0,0,0,0,36047017200,11214
172,2003,0,15,15,31,15,15,-0.516129,-16,0,0,0,0,36047017200,11214
172,2003,1,34,15,25,34,34,0.36,9,0,0,0,0,36047017200,11214
172,2003,2,29,34,21,29,29,0.380952,8,0,0,0,0,36047017200,11214
172,2003,3,17,29,25,17,17,-0.32,-8,0,0,0,0,36047017200,11214
172,2003,4,21,17,24,21,21,-0.125,-3,0,0,0,0,36047017200,11214
172,2003,5,23,21,24,23,23,-0.041667,-1,0,0,0,0,36047017200,11214
172,2004,0,21,21,15,25,25,0.4,6,-0.16,-4,-0.16,-4,36047017200,11214
172,2004,1,17,21,34,19,19,-0.5,-17,-0.105263,-2,-0.105263,-2,36047017200,11214
172,2004,2,34,17,29,20,20,0.172414,5,0.7,14,0.7,14,36047017200,11214
172,2004,3,33,34,17,25,25,0.941176,16,0.32,8,0.32,8,36047017200,11214
172,2004,4,25,33,21,23,23,0.190476,4,0.086957,2,0.086957,2,36047017200,11214
172,2004,5,23,25,23,29,29,0,0,-0.206897,-6,-0.206897,-6,36047017200,11214
172,2005,0,23,23,21,31,31,0.095238,2,-0.258065,-8,-0.258065,-8,36047017200,11214
172,2005,1,26,23,17,25,25,0.529412,9,0.04,1,0.04,1,36047017200,11214
172,2005,2,15,26,34,21,21,-0.558824,-19,-0.285714,-6,-0.285714,-6,36047017200,11214
172,2005,3,38,15,33,25,25,0.151515,5,0.52,13,0.52,13,36047017200,11214
172,2005,4,33,38,25,24,24,0.32,8,0.375,9,0.375,9,36047017200,11214
172,2005,5,30,33,23,24,24,0.304348,7,0.25,6,0.25,6,36047017200,11214
172,2006,0,14,14,23,15,15,-0.391304,-9,-0.066667,-1,-0.066667,-1,36047017200,11214
172,2006,1,26,14,26,34,34,0,0,-0.235294,-8,-0.235294,-8,36047017200,11214
172,2006,2,29,26,15,29,29,0.933333,14,0,0,0,0,36047017200,11214
172,2006,3,16,29,38,17,17,-0.578947,-22,-0.058824,-1,-0.058824,-1,36047017200,11214
172,2006,4,41,16,33,21,21,0.242424,8,0.952381,20,0.952381,20,36047017200,11214
172,2006,5,39,41,30,23,23,0.3,9,0.695652,16,0.695652,16,36047017200,11214
172,2007,0,17,17,14,21,21,0.214286,3,-0.190476,-4,-0.190476,-4,36047017200,11214
172,2007,1,16,17,26,17,17,-0.384615,-10,-0.058824,-1,-0.058824,-1,36047017200,11214
172,2007,2,22,16,29,34,34,-0.241379,-7,-0.352941,-12,-0.352941,-12,36047017200,11214
172,2007,3,32,22,16,33,33,1,16,-0.030303,-1,-0.030303,-1,36047017200,11214
172,2007,4,25,32,41,25,25,-0.390244,-16,0,0,0,0,36047017200,11214
172,2007,5,41,25,39,23,23,0.051282,2,0.782609,18,0.782609,18,36047017200,11214
172,2008,0,33,33,17,23,23,0.941176,16,0.434783,10,0.434783,10,36047017200,11214
172,2008,1,19,33,16,26,26,0.1875,3,-0.269231,-7,-0.269231,-7,36047017200,11214
172,2008,2,15,19,22,15,15,-0.318182,-7,0,0,0,0,36047017200,11214
172,2008,3,27,15,32,38,38,-0.15625,-5,-0.289474,-11,-0.289474,-11,36047017200,11214
172,2008,4,34,27,25,33,33,0.36,9,0.030303,1,0.030303,1,36047017200,11214
172,2008,5,25,34,41,30,30,-0.390244,-16,-0.166667,-5,-0.166667,-5,36047017200,11214
172,2009,0,18,18,33,14,14,-0.454545,-15,0.285714,4,0.285714,4,36047017200,11214
172,2009,1,36,18,19,26,26,0.894737,17,0.384615,10,0.384615,10,36047017200,11214
172,2009,2,25,36,15,29,29,0.666667,10,-0.137931,-4,-0.137931,-4,36047017200,11214
172,2009,3,13,25,27,16,16,-0.518519,-14,-0.1875,-3,-0.1875,-3,36047017200,11214
172,2009,4,27,13,34,41,41,-0.205882,-7,-0.341463,-14,-0.341463,-14,36047017200,11214
172,2009,5,32,27,25,39,39,0.28,7,-0.179487,-7,-0.179487,-7,36047017200,11214
172,2010,0,44,44,18,17,17,1.444444,26,1.588235,27,1.588235,27,36047017200,11214
172,2010,1,17,44,36,16,16,-0.527778,-19,0.0625,1,0.0625,1,36047017200,11214
172,2010,2,44,17,25,22,22,0.76,19,1,22,1,22,36047017200,11214
172,2010,3,25,44,13,32,32,0.923077,12,-0.21875,-7,-0.21875,-7,36047017200,11214
172,2010,4,13,25,27,25,25,-0.518519,-14,-0.48,-12,-0.48,-12,36047017200,11214
172,2010,5,26,13,32,41,41,-0.1875,-6,-0.365854,-15,-0.365854,-15,36047017200,11214
174,2001,0,13,13,13,13,13,0,0,0,0,0,0,36047017400,11214
174,2001,1,14,13,14,14,14,0,0,0,0,0,0,36047017400,11214
174,2001,2,8,14,8,8,8,0,0,0,0,0,0,36047017400,11214
174,2001,3,11,8,11,11,11,0,0,0,0,0,0,36047017400,11214
174,2001,4,8,11,8,8,8,0,0,0,0,0,0,36047017400,11214
174,2001,5,7,8,7,7,7,0,0,0,0,0,0,36047017400,11214
174,2002,0,10,10,13,10,10,-0.230769,-3,0,0,0,0,36047017400,11214
174,2002,1,13,10,14,13,13,-0.071429,-1,0,0,0,0,36047017400,11214
174,2002,2,16,13,8,16,16,1,8,0,0,0,0,36047017400,11214
174,2002,3,9,16,11,9,9,-0.181818,-2,0,0,0,0,36047017400,11214
174,2002,4,12,9,8,12,12,0.5,4,0,0,0,0,36047017400,11214
174,2002,5,8,12,7,8,8,0.142857,1,0,0,0,0,36047017400,11214
174,2003,0,12,12,10,12,12,0.2,2,0,0,0,0,36047017400,11214
174,2003,1,8,12,13,8,8,-0.384615,-5,0,0,0,0,36047017400,11214
174,2003,2,13,8,16,13,13,-0.1875,-3,0,0,0,0,36047017400,11214
174,2003,3,14,13,9,14,14,0.555556,5,0,0,0,0,36047017400,11214
174,2003,4,13,14,12,13,13,0.083333,1,0,0,0,0,36047017400,11214
174,2003,5,12,13,8,12,12,0.5,4,0,0,0,0,36047017400,11214
174,2004,0,10,10,12,13,13,-0.166667,-2,-0.230769,-3,-0.230769,-3,36047017400,11214
174,2004,1,13,10,8,14,14,0.625,5,-0.071429,-1,-0.071429,-1,36047017400,11214
174,2004,2,13,13,13,8,8,0,0,0.625,5,0.625,5,36047017400,11214
174,2004,3,13,13,14,11,11,-0.071429,-1,0.181818,2,0.181818,2,36047017400,11214
174,2004,4,15,13,13,8,8,0.153846,2,0.875,7,0.875,7,36047017400,11214
174,2004,5,13,15,12,7,7,0.083333,1,0.857143,6,0.857143,6,36047017400,11214
174,2005,0,6,6,10,10,10,-0.4,-4,-0.4,-4,-0.4,-4,36047017400,11214
174,2005,1,10,6,13,13,13,-0.230769,-3,-0.230769,-3,-0.230769,-3,36047017400,11214
174,2005,2,15,10,13,16,16,0.153846,2,-0.0625,-1,-0.0625,-1,36047017400,11214
174,2005,3,13,15,13,9,9,0,0,0.444444,4,0.444444,4,36047017400,11214
174,2005,4,12,13,15,12,12,-0.2,-3,0,0,0,0,36047017400,11214
174,2005,5,12,12,13,8,8,-0.076923,-1,0.5,4,0.5,4,36047017400,11214
174,2006,0,3,3,6,12,12,-0.5,-3,-0.75,-9,-0.75,-9,36047017400,11214
174,2006,1,5,3,10,8,8,-0.5,-5,-0.375,-3,-0.375,-3,36047017400,11214
174,2006,2,10,5,15,13,13,-0.333333,-5,-0.230769,-3,-0.230769,-3,36047017400,11214
174,2006,3,14,10,13,14,14,0.076923,1,0,0,0,0,36047017400,11214
174,2006,4,12,14,12,13,13,0,0,-0.076923,-1,-0.076923,-1,36047017400,11214
174,2006,5,13,12,12,12,12,0.083333,1,0.083333,1,0.083333,1,36047017400,11214
174,2007,0,9,9,3,10,10,2,6,-0.1,-1,-0.1,-1,36047017400,11214
174,2007,1,3,9,5,13,13,-0.4,-2,-0.769231,-10,-0.769231,-10,36047017400,11214
174,2007,2,6,3,10,13,13,-0.4,-4,-0.538462,-7,-0.538462,-7,36047017400,11214
174,2007,3,5,6,14,13,13,-0.642857,-9,-0.615385,-8,-0.615385,-8,36047017400,11214
174,2007,4,14,5,12,15,15,0.166667,2,-0.066667,-1,-0.066667,-1,36047017400,11214
174,2007,5,13,14,13,13,13,0,0,0,0,0,0,36047017400,11214
174,2008,0,15,15,9,6,6,0.666667,6,1.5,9,1.5,9,36047017400,11214
174,2008,1,9,15,3,10,10,2,6,-0.1,-1,-0.1,-1,36047017400,11214
174,2008,2,3,9,6,15,15,-0.5,-3,-0.8,-12,-0.8,-12,36047017400,11214
174,2008,3,8,3,5,13,13,0.6,3,-0.384615,-5,-0.384615,-5,36047017400,11214
174,2008,4,6,8,14,12,12,-0.571429,-8,-0.5,-6,-0.5,-6,36047017400,11214
174,2008,5,14,6,13,12,12,0.076923,1,0.166667,2,0.166667,2,36047017400,11214
174,2009,0,7,7,15,3,3,-0.533333,-8,1.333333,4,1.333333,4,36047017400,11214
174,2009,1,15,7,9,5,5,0.666667,6,2,10,2,10,36047017400,11214
174,2009,2,11,15,3,10,10,2.666667,8,0.1,1,0.1,1,36047017400,11214
174,2009,3,5,11,8,14,14,-0.375,-3,-0.642857,-9,-0.642857,-9,36047017400,11214
174,2009,4,10,5,6,12,12,0.666667,4,-0.166667,-2,-0.166667,-2,36047017400,11214
174,2009,5,7,10,14,13,13,-0.5,-7,-0.461538,-6,-0.461538,-6,36047017400,11214
174,2010,0,15,15,7,9,9,1.142857,8,0.666667,6,0.666667,6,36047017400,11214
174,2010,1,7,15,15,3,3,-0.533333,-8,1.333333,4,1.333333,4,36047017400,11214
174,2010,2,17,7,11,6,6,0.545455,6,1.833333,11,1.833333,11,36047017400,11214
174,2010,3,9,17,5,5,5,0.8,4,0.8,4,0.8,4,36047017400,11214
174,2010,4,4,9,10,14,14,-0.6,-6,-0.714286,-10,-0.714286,-10,36047017400,11214
174,2010,5,8,4,7,13,13,0.142857,1,-0.384615,-5,-0.384615,-5,36047017400,11214
176,2001,0,19,19,19,19,19,0,0,0,0,0,0,36047017600,11214
176,2001,1,24,19,24,24,24,0,0,0,0,0,0,36047017600,11214
176,2001,2,16,24,16,16,16,0,0,0,0,0,0,36047017600,11214
176,2001,3,22,16,22,22,22,0,0,0,0,0,0,36047017600,11214
176,2001,4,15,22,15,15,15,0,0,0,0,0,0,36047017600,11214
176,2001,5,15,15,15,15,15,0,0,0,0,0,0,36047017600,11214
176,2002,0,20,20,19,20,20,0.052632,1,0,0,0,0,36047017600,11214
176,2002,1,14,20,24,14,14,-0.416667,-10,0,0,0,0,36047017600,11214
176,2002,2,25,14,16,25,25,0.5625,9,0,0,0,0,36047017600,11214
176,2002,3,15,25,22,15,15,-0.318182,-7,0,0,0,0,36047017600,11214
176,2002,4,19,15,15,19,19,0.266667,4,0,0,0,0,36047017600,11214
176,2002,5,14,19,15,14,14,-0.066667,-1,0,0,0,0,36047017600,11214
176,2003,0,11,11,20,11,11,-0.45,-9,0,0,0,0,36047017600,11214
176,2003,1,17,11,14,17,17,0.214286,3,0,0,0,0,36047017600,11214
176,2003,2,17,17,25,17,17,-0.32,-8,0,0,0,0,36047017600,11214
176,2003,3,24,17,15,24,24,0.6,9,0,0,0,0,36047017600,11214
176,2003,4,17,24,19,17,17,-0.105263,-2,0,0,0,0,36047017600,11214
176,2003,5,15,17,14,15,15,0.071429,1,0,0,0,0,36047017600,11214
176,2004,0,10,10,11,19,19,-0.090909,-1,-0.473684,-9,-0.473684,-9,36047017600,11214
176,2004,1,12,10,17,24,24,-0.294118,-5,-0.5,-12,-0.5,-12,36047017600,11214
176,2004,2,15,12,17,16,16,-0.117647,-2,-0.0625,-1,-0.0625,-1,36047017600,11214
176,2004,3,13,15,24,22,22,-0.458333,-11,-0.409091,-9,-0.409091,-9,36047017600,11214
176,2004,4,19,13,17,15,15,0.117647,2,0.266667,4,0.266667,4,36047017600,11214
176,2004,5,17,19,15,15,15,0.133333,2,0.133333,2,0.133333,2,36047017600,11214
176,2005,0,7,7,10,20,20,-0.3,-3,-0.65,-13,-0.65,-13,36047017600,11214
176,2005,1,9,7,12,14,14,-0.25,-3,-0.357143,-5,-0.357143,-5,36047017600,11214
176,2005,2,12,9,15,25,25,-0.2,-3,-0.52,-13,-0.52,-13,36047017600,11214
176,2005,3,14,12,13,15,15,0.076923,1,-0.066667,-1,-0.066667,-1,36047017600,11214
176,2005,4,14,14,19,19,19,-0.263158,-5,-0.263158,-5,-0.263158,-5,36047017600,11214
176,2005,5,15,14,17,14,14,-0.117647,-2,0.071429,1,0.071429,1,36047017600,11214
176,2006,0,5,5,7,11,11,-0.285714,-2,-0.545455,-6,-0.545455,-6,36047017600,11214
176,2006,1,8,5,9,17,17,-0.111111,-1,-0.529412,-9,-0.529412,-9,36047017600,11214
176,2006,2,9,8,12,17,17,-0.25,-3,-0.470588,-8,-0.470588,-8,36047017600,11214
176,2006,3,14,9,14,24,24,0,0,-0.416667,-10,-0.416667,-10,36047017600,11214
176,2006,4,14,14,14,17,17,0,0,-0.176471,-3,-0.176471,-3,36047017600,11214
176,2006,5,13,14,15,15,15,-0.133333,-2,-0.133333,-2,-0.133333,-2,36047017600,11214
176,2007,0,5,5,5,10,10,0,0,-0.5,-5,-0.5,-5,36047017600,11214
176,2007,1,5,5,8,12,12,-0.375,-3,-0.583333,-7,-0.583333,-7,36047017600,11214
176,2007,2,10,5,9,15,15,0.111111,1,-0.333333,-5,-0.333333,-5,36047017600,11214
176,2007,3,8,10,14,13,13,-0.428571,-6,-0.384615,-5,-0.384615,-5,36047017600,11214
176,2007,4,14,8,14,19,19,0,0,-0.263158,-5,-0.263158,-5,36047017600,11214
176,2007,5,12,14,13,17,17,-0.076923,-1,-0.294118,-5,-0.294118,-5,36047017600,11214
176,2008,0,12,12,5,7,7,1.4,7,0.714286,5,0.714286,5,36047017600,11214
176,2008,1,4,12,5,9,9,-0.2,-1,-0.555556,-5,-0.555556,-5,36047017600,11214
176,2008,2,4,4,10,12,12,-0.6,-6,-0.666667,-8,-0.666667,-8,36047017600,11214
176,2008,3,9,4,8,14,14,0.125,1,-0.357143,-5,-0.357143,-5,36047017600,11214
176,2008,4,6,9,14,14,14,-0.571429,-8,-0.571429,-8,-0.571429,-8,36047017600,11214
176,2008,5,12,6,12,15,15,0,0,-0.2,-3,-0.2,-3,36047017600,11214
176,2009,0,10,10,12,5,5,-0.166667,-2,1,5,1,5,36047017600,11214
176,2009,1,16,10,4,8,8,3,12,1,8,1,8,36047017600,11214
176,2009,2,5,16,4,9,9,0.25,1,-0.444444,-4,-0.444444,-4,36047017600,11214
176,2009,3,6,5,9,14,14,-0.333333,-3,-0.571429,-8,-0.571429,-8,36047017600,11214
176,2009,4,8,6,6,14,14,0.333333,2,-0.428571,-6,-0.428571,-6,36047017600,11214
176,2009,5,6,8,12,13,13,-0.5,-6,-0.538462,-7,-0.538462,-7,36047017600,11214
176,2010,0,24,24,10,5,5,1.4,14,3.8,19,3.8,19,36047017600,11214
176,2010,1,10,24,16,5,5,-0.375,-6,1,5,1,5,36047017600,11214
176,2010,2,13,10,5,10,10,1.6,8,0.3,3,0.3,3,36047017600,11214
176,2010,3,6,13,6,8,8,0,0,-0.25,-2,-0.25,-2,36047017600,11214
176,2010,4,7,6,8,14,14,-0.125,-1,-0.5,-7,-0.5,-7,36047017600,11214
176,2010,5,8,7,6,12,12,0.333333,2,-0.333333,-4,-0.333333,-4,36047017600,11214
178,2001,0,27,27,27,27,27,0,0,0,0,0,0,36047017800,11214
178,2001,1,20,27,20,20,20,0,0,0,0,0,0,36047017800,11214
178,2001,2,28,20,28,28,28,0,0,0,0,0,0,36047017800,11214
178,2001,3,30,28,30,30,30,0,0,0,0,0,0,36047017800,11214
178,2001,4,17,30,17,17,17,0,0,0,0,0,0,36047017800,11214
178,2001,5,19,17,19,19,19,0,0,0,0,0,0,36047017800,11214
178,2002,0,23,23,27,23,23,-0.148148,-4,0,0,0,0,36047017800,11214
178,2002,1,25,23,20,25,25,0.25,5,0,0,0,0,36047017800,11214
178,2002,2,23,25,28,23,23,-0.178571,-5,0,0,0,0,36047017800,11214
178,2002,3,31,23,30,31,31,0.033333,1,0,0,0,0,36047017800,11214
178,2002,4,24,31,17,24,24,0.411765,7,0,0,0,0,36047017800,11214
178,2002,5,18,24,19,18,18,-0.052632,-1,0,0,0,0,36047017800,11214
178,2003,0,15,15,23,15,15,-0.347826,-8,0,0,0,0,36047017800,11214
178,2003,1,21,15,25,21,21,-0.16,-4,0,0,0,0,36047017800,11214
178,2003,2,18,21,23,18,18,-0.217391,-5,0,0,0,0,36047017800,11214
178,2003,3,24,18,31,24,24,-0.225806,-7,0,0,0,0,36047017800,11214
178,2003,4,27,24,24,27,27,0.125,3,0,0,0,0,36047017800,11214
178,2003,5,26,27,18,26,26,0.444444,8,0,0,0,0,36047017800,11214
178,2004,0,18,18,15,27,27,0.2,3,-0.333333,-9,-0.333333,-9,36047017800,11214
178,2004,1,13,18,21,20,20,-0.380952,-8,-0.35,-7,-0.35,-7,36047017800,11214
178,2004,2,20,13,18,28,28,0.111111,2,-0.285714,-8,-0.285714,-8,36047017800,11214
178,2004,3,25,20,24,30,30,0.041667,1,-0.166667,-5,-0.166667,-5,36047017800,11214
178,2004,4,21,25,27,17,17,-0.222222,-6,0.235294,4,0.235294,4,36047017800,11214
178,2004,5,24,21,26,19,19,-0.076923,-2,0.263158,5,0.263158,5,36047017800,11214
178,2005,0,14,14,18,23,23,-0.222222,-4,-0.391304,-9,-0.391304,-9,36047017800,11214
178,2005,1,17,14,13,25,25,0.307692,4,-0.32,-8,-0.32,-8,36047017800,11214
178,2005,2,14,17,20,23,23,-0.3,-6,-0.391304,-9,-0.391304,-9,36047017800,11214
178,2005,3,16,14,25,31,31,-0.36,-9,-0.483871,-15,-0.483871,-15,36047017800,11214
178,2005,4,19,16,21,24,24,-0.095238,-2,-0.208333,-5,-0.208333,-5,36047017800,11214
178,2005,5,21,19,24,18,18,-0.125,-3,0.166667,3,0.166667,3,36047017800,11214
178,2006,0,21,21,14,15,15,0.5,7,0.4,6,0.4,6,36047017800,11214
178,2006,1,18,21,17,21,21,0.058824,1,-0.142857,-3,-0.142857,-3,36047017800,11214
178,2006,2,17,18,14,18,18,0.214286,3,-0.055556,-1,-0.055556,-1,36047017800,11214
178,2006,3,20,17,16,24,24,0.25,4,-0.166667,-4,-0.166667,-4,36047017800,11214
178,2006,4,16,20,19,27,27,-0.157895,-3,-0.407407,-11,-0.407407,-11,36047017800,11214
178,2006,5,19,16,21,26,26,-0.095238,-2,-0.269231,-7,-0.269231,-7,36047017800,11214
178,2007,0,15,15,21,18,18,-0.285714,-6,-0.166667,-3,-0.166667,-3,36047017800,11214
178,2007,1,23,15,18,13,13,0.277778,5,0.769231,10,0.769231,10,36047017800,11214
178,2007,2,18,23,17,20,20,0.058824,1,-0.1,-2,-0.1,-2,36047017800,11214
178,2007,3,16,18,20,25,25,-0.2,-4,-0.36,-9,-0.36,-9,36047017800,11214
178,2007,4,22,16,16,21,21,0.375,6,0.047619,1,0.047619,1,36047017800,11214
178,2007,5,23,22,19,24,24,0.210526,4,-0.041667,-1,-0.041667,-1,36047017800,11214
178,2008,0,15,15,15,14,14,0,0,0.071429,1,0.071429,1,36047017800,11214
178,2008,1,13,15,23,17,17,-0.434783,-10,-0.235294,-4,-0.235294,-4,36047017800,11214
178,2008,2,17,13,18,14,14,-0.055556,-1,0.214286,3,0.214286,3,36047017800,11214
178,2008,3,17,17,16,16,16,0.0625,1,0.0625,1,0.0625,1,36047017800,11214
178,2008,4,14,17,22,19,19,-0.363636,-8,-0.263158,-5,-0.263158,-5,36047017800,11214
178,2008,5,21,14,23,21,21,-0.086957,-2,0,0,0,0,36047017800,11214
178,2009,0,19,19,15,21,21,0.266667,4,-0.095238,-2,-0.095238,-2,36047017800,11214
178,2009,1,19,19,13,18,18,0.461538,6,0.055556,1,0.055556,1,36047017800,11214
178,2009,2,14,19,17,17,17,-0.176471,-3,-0.176471,-3,-0.176471,-3,36047017800,11214
178,2009,3,17,14,17,20,20,0,0,-0.15,-3,-0.15,-3,36047017800,11214
178,2009,4,16,17,14,16,16,0.142857,2,0,0,0,0,36047017800,11214
178,2009,5,17,16,21,19,19,-0.190476,-4,-0.105263,-2,-0.105263,-2,36047017800,11214
178,2010,0,30,30,19,15,15,0.578947,11,1,15,1,15,36047017800,11214
178,2010,1,22,30,19,23,23,0.157895,3,-0.043478,-1,-0.043478,-1,36047017800,11214
178,2010,2,18,22,14,18,18,0.285714,4,0,0,0,0,36047017800,11214
178,2010,3,13,18,17,16,16,-0.235294,-4,-0.1875,-3,-0.1875,-3,36047017800,11214
178,2010,4,15,13,16,22,22,-0.0625,-1,-0.318182,-7,-0.318182,-7,36047017800,11214
178,2010,5,14,15,17,23,23,-0.176471,-3,-0.391304,-9,-0.391304,-9,36047017800,11214
180,2001,0,27,27,27,27,27,0,0,0,0,0,0,36047018000,11214
180,2001,1,21,27,21,21,21,0,0,0,0,0,0,36047018000,11214
180,2001,2,26,21,26,26,26,0,0,0,0,0,0,36047018000,11214
180,2001,3,20,26,20,20,20,0,0,0,0,0,0,36047018000,11214
180,2001,4,25,20,25,25,25,0,0,0,0,0,0,36047018000,11214
180,2001,5,23,25,23,23,23,0,0,0,0,0,0,36047018000,11214
180,2002,0,25,25,27,25,25,-0.074074,-2,0,0,0,0,36047018000,11214
180,2002,1,27,25,21,27,27,0.285714,6,0,0,0,0,36047018000,11214
180,2002,2,26,27,26,26,26,0,0,0,0,0,0,36047018000,11214
180,2002,3,27,26,20,27,27,0.35,7,0,0,0,0,36047018000,11214
180,2002,4,24,27,25,24,24,-0.04,-1,0,0,0,0,36047018000,11214
180,2002,5,25,24,23,25,25,0.086957,2,0,0,0,0,36047018000,11214
180,2003,0,28,28,25,28,28,0.12,3,0,0,0,0,36047018000,11214
180,2003,1,28,28,27,28,28,0.037037,1,0,0,0,0,36047018000,11214
180,2003,2,30,28,26,30,30,0.153846,4,0,0,0,0,36047018000,11214
180,2003,3,26,30,27,26,26,-0.037037,-1,0,0,0,0,36047018000,11214
180,2003,4,31,26,24,31,31,0.291667,7,0,0,0,0,36047018000,11214
180,2003,5,20,31,25,20,20,-0.2,-5,0,0,0,0,36047018000,11214
180,2004,0,22,22,28,27,27,-0.214286,-6,-0.185185,-5,-0.185185,-5,36047018000,11214
180,2004,1,30,22,28,21,21,0.071429,2,0.428571,9,0.428571,9,36047018000,11214
180,2004,2,29,30,30,26,26,-0.033333,-1,0.115385,3,0.115385,3,36047018000,11214
180,2004,3,28,29,26,20,20,0.076923,2,0.4,8,0.4,8,36047018000,11214
180,2004,4,28,28,31,25,25,-0.096774,-3,0.12,3,0.12,3,36047018000,11214
180,2004,5,34,28,20,23,23,0.7,14,0.478261,11,0.478261,11,36047018000,11214
180,2005,0,28,28,22,25,25,0.272727,6,0.12,3,0.12,3,36047018000,11214
180,2005,1,19,28,30,27,27,-0.366667,-11,-0.296296,-8,-0.296296,-8,36047018000,11214
180,2005,2,27,19,29,26,26,-0.068966,-2,0.038462,1,0.038462,1,36047018000,11214
180,2005,3,27,27,28,27,27,-0.035714,-1,0,0,0,0,36047018000,11214
180,2005,4,32,27,28,24,24,0.142857,4,0.333333,8,0.333333,8,36047018000,11214
180,2005,5,33,32,34,25,25,-0.029412,-1,0.32,8,0.32,8,36047018000,11214
180,2006,0,19,19,28,28,28,-0.321429,-9,-0.321429,-9,-0.321429,-9,36047018000,11214
180,2006,1,25,19,19,28,28,0.315789,6,-0.107143,-3,-0.107143,-3,36047018000,11214
180,2006,2,22,25,27,30,30,-0.185185,-5,-0.266667,-8,-0.266667,-8,36047018000,11214
180,2006,3,26,22,27,26,26,-0.037037,-1,0,0,0,0,36047018000,11214
180,2006,4,23,26,32,31,31,-0.28125,-9,-0.258065,-8,-0.258065,-8,36047018000,11214
180,2006,5,29,23,33,20,20,-0.121212,-4,0.45,9,0.45,9,36047018000,11214
180,2007,0,20,20,19,22,22,0.052632,1,-0.090909,-2,-0.090909,-2,36047018000,11214
180,2007,1,19,20,25,30,30,-0.24,-6,-0.366667,-11,-0.366667,-11,36047018000,11214
180,2007,2,20,19,22,29,29,-0.090909,-2,-0.310345,-9,-0.310345,-9,36047018000,11214
180,2007,3,20,20,26,28,28,-0.230769,-6,-0.285714,-8,-0.285714,-8,36047018000,11214
180,2007,4,28,20,23,28,28,0.217391,5,0,0,0,0,36047018000,11214
180,2007,5,19,28,29,34,34,-0.344828,-10,-0.441176,-15,-0.441176,-15,36047018000,11214
180,2008,0,24,24,20,28,28,0.2,4,-0.142857,-4,-0.142857,-4,36047018000,11214
180,2008,1,14,24,19,19,19,-0.263158,-5,-0.263158,-5,-0.263158,-5,36047018000,11214
180,2008,2,18,14,20,27,27,-0.1,-2,-0.333333,-9,-0.333333,-9,36047018000,11214
180,2008,3,22,18,20,27,27,0.1,2,-0.185185,-5,-0.185185,-5,36047018000,11214
180,2008,4,23,22,28,32,32,-0.178571,-5,-0.28125,-9,-0.28125,-9,36047018000,11214
180,2008,5,28,23,19,33,33,0.473684,9,-0.151515,-5,-0.151515,-5,36047018000,11214
180,2009,0,23,23,24,19,19,-0.041667,-1,0.210526,4,0.210526,4,36047018000,11214
180,2009,1,29,23,14,25,25,1.071429,15,0.16,4,0.16,4,36047018000,11214
180,2009,2,16,29,18,22,22,-0.111111,-2,-0.272727,-6,-0.272727,-6,36047018000,11214
180,2009,3,17,16,22,26,26,-0.227273,-5,-0.346154,-9,-0.346154,-9,36047018000,11214
180,2009,4,22,17,23,23,23,-0.043478,-1,-0.043478,-1,-0.043478,-1,36047018000,11214
180,2009,5,25,22,28,29,29,-0.107143,-3,-0.137931,-4,-0.137931,-4,36047018000,11214
180,2010,0,28,28,23,20,20,0.217391,5,0.4,8,0.4,8,36047018000,11214
180,2010,1,19,28,29,19,19,-0.344828,-10,0,0,0,0,36047018000,11214
180,2010,2,30,19,16,20,20,0.875,14,0.5,10,0.5,10,36047018000,11214
180,2010,3,14,30,17,20,20,-0.176471,-3,-0.3,-6,-0.3,-6,36047018000,11214
180,2010,4,13,14,22,28,28,-0.409091,-9,-0.535714,-15,-0.535714,-15,36047018000,11214
180,2010,5,21,13,25,19,19,-0.16,-4,0.105263,2,0.105263,2,36047018000,11214
182,2001,0,34,34,34,34,34,0,0,0,0,0,0,36047018200,11214
182,2001,1,35,34,35,35,35,0,0,0,0,0,0,36047018200,11214
182,2001,2,29,35,29,29,29,0,0,0,0,0,0,36047018200,11214
182,2001,3,21,29,21,21,21,0,0,0,0,0,0,36047018200,11214
182,2001,4,22,21,22,22,22,0,0,0,0,0,0,36047018200,11214
182,2001,5,25,22,25,25,25,0,0,0,0,0,0,36047018200,11214
182,2002,0,35,35,34,35,35,0.029412,1,0,0,0,0,36047018200,11214
182,2002,1,32,35,35,32,32,-0.085714,-3,0,0,0,0,36047018200,11214
182,2002,2,35,32,29,35,35,0.206897,6,0,0,0,0,36047018200,11214
182,2002,3,32,35,21,32,32,0.52381,11,0,0,0,0,36047018200,11214
182,2002,4,23,32,22,23,23,0.045455,1,0,0,0,0,36047018200,11214
182,2002,5,21,23,25,21,21,-0.16,-4,0,0,0,0,36047018200,11214
182,2003,0,28,28,35,28,28,-0.2,-7,0,0,0,0,36047018200,11214
182,2003,1,33,28,32,33,33,0.03125,1,0,0,0,0,36047018200,11214
182,2003,2,30,33,35,30,30,-0.142857,-5,0,0,0,0,36047018200,11214
182,2003,3,36,30,32,36,36,0.125,4,0,0,0,0,36047018200,11214
182,2003,4,28,36,23,28,28,0.217391,5,0,0,0,0,36047018200,11214
182,2003,5,25,28,21,25,25,0.190476,4,0,0,0,0,36047018200,11214
182,2004,0,24,24,28,34,34,-0.142857,-4,-0.294118,-10,-0.294118,-10,36047018200,11214
182,2004,1,29,24,33,35,35,-0.121212,-4,-0.171429,-6,-0.171429,-6,36047018200,11214
182,2004,2,29,29,30,29,29,-0.033333,-1,0,0,0,0,36047018200,11214
182,2004,3,34,29,36,21,21,-0.055556,-2,0.619048,13,0.619048,13,36047018200,11214
182,2004,4,36,34,28,22,22,0.285714,8,0.636364,14,0.636364,14,36047018200,11214
182,2004,5,25,36,25,25,25,0,0,0,0,0,0,36047018200,11214
182,2005,0,26,26,24,35,35,0.083333,2,-0.257143,-9,-0.257143,-9,36047018200,11214
182,2005,1,26,26,29,32,32,-0.103448,-3,-0.1875,-6,-0.1875,-6,36047018200,11214
182,2005,2,32,26,29,35,35,0.103448,3,-0.085714,-3,-0.085714,-3,36047018200,11214
182,2005,3,31,32,34,32,32,-0.088235,-3,-0.03125,-1,-0.03125,-1,36047018200,11214
182,2005,4,38,31,36,23,23,0.055556,2,0.652174,15,0.652174,15,36047018200,11214
182,2005,5,38,38,25,21,21,0.52,13,0.809524,17,0.809524,17,36047018200,11214
182,2006,0,31,31,26,28,28,0.192308,5,0.107143,3,0.107143,3,36047018200,11214
182,2006,1,28,31,26,33,33,0.076923,2,-0.151515,-5,-0.151515,-5,36047018200,11214
182,2006,2,23,28,32,30,30,-0.28125,-9,-0.233333,-7,-0.233333,-7,36047018200,11214
182,2006,3,34,23,31,36,36,0.096774,3,-0.055556,-2,-0.055556,-2,36047018200,11214
182,2006,4,31,34,38,28,28,-0.184211,-7,0.107143,3,0.107143,3,36047018200,11214
182,2006,5,37,31,38,25,25,-0.026316,-1,0.48,12,0.48,12,36047018200,11214
182,2007,0,29,29,31,24,24,-0.064516,-2,0.208333,5,0.208333,5,36047018200,11214
182,2007,1,32,29,28,29,29,0.142857,4,0.103448,3,0.103448,3,36047018200,11214
182,2007,2,29,32,23,29,29,0.26087,6,0,0,0,0,36047018200,11214
182,2007,3,30,29,34,34,34,-0.117647,-4,-0.117647,-4,-0.117647,-4,36047018200,11214
182,2007,4,35,30,31,36,36,0.129032,4,-0.027778,-1,-0.027778,-1,36047018200,11214
182,2007,5,28,35,37,25,25,-0.243243,-9,0.12,3,0.12,3,36047018200,11214
182,2008,0,20,20,29,26,26,-0.310345,-9,-0.230769,-6,-0.230769,-6,36047018200,11214
182,2008,1,31,20,32,26,26,-0.03125,-1,0.192308,5,0.192308,5,36047018200,11214
182,2008,2,32,31,29,32,32,0.103448,3,0,0,0,0,36047018200,11214
182,2008,3,28,32,30,31,31,-0.066667,-2,-0.096774,-3,-0.096774,-3,36047018200,11214
182,2008,4,29,28,35,38,38,-0.171429,-6,-0.236842,-9,-0.236842,-9,36047018200,11214
182,2008,5,34,29,28,38,38,0.214286,6,-0.105263,-4,-0.105263,-4,36047018200,11214
182,2009,0,33,33,20,31,31,0.65,13,0.064516,2,0.064516,2,36047018200,11214
182,2009,1,27,33,31,28,28,-0.129032,-4,-0.035714,-1,-0.035714,-1,36047018200,11214
182,2009,2,32,27,32,23,23,0,0,0.391304,9,0.391304,9,36047018200,11214
182,2009,3,39,32,28,34,34,0.392857,11,0.147059,5,0.147059,5,36047018200,11214
182,2009,4,31,39,29,31,31,0.068966,2,0,0,0,0,36047018200,11214
182,2009,5,31,31,34,37,37,-0.088235,-3,-0.162162,-6,-0.162162,-6,36047018200,11214
182,2010,0,37,37,33,29,29,0.121212,4,0.275862,8,0.275862,8,36047018200,11214
182,2010,1,37,37,27,32,32,0.37037,10,0.15625,5,0.15625,5,36047018200,11214
182,2010,2,29,37,32,29,29,-0.09375,-3,0,0,0,0,36047018200,11214
182,2010,3,40,29,39,30,30,0.025641,1,0.333333,10,0.333333,10,36047018200,11214
182,2010,4,35,40,31,35,35,0.129032,4,0,0,0,0,36047018200,11214
182,2010,5,39,35,31,28,28,0.258065,8,0.392857,11,0.392857,11,36047018200,11214
184,2001,0,26,26,26,26,26,0,0,0,0,0,0,36047018400,11214
184,2001,1,13,26,13,13,13,0,0,0,0,0,0,36047018400,11214
184,2001,2,18,13,18,18,18,0,0,0,0,0,0,36047018400,11214
184,2001,3,16,18,16,16,16,0,0,0,0,0,0,36047018400,11214
184,2001,4,22,16,22,22,22,0,0,0,0,0,0,36047018400,11214
184,2001,5,11,22,11,11,11,0,0,0,0,0,0,36047018400,11214
184,2002,0,27,27,26,27,27,0.038462,1,0,0,0,0,36047018400,11214
184,2002,1,30,27,13,30,30,1.307692,17,0,0,0,0,36047018400,11214
184,2002,2,11,30,18,11,11,-0.388889,-7,0,0,0,0,36047018400,11214
184,2002,3,20,11,16,20,20,0.25,4,0,0,0,0,36047018400,11214
184,2002,4,19,20,22,19,19,-0.136364,-3,0,0,0,0,36047018400,11214
184,2002,5,18,19,11,18,18,0.636364,7,0,0,0,0,36047018400,11214
184,2003,0,23,23,27,23,23,-0.148148,-4,0,0,0,0,36047018400,11214
184,2003,1,25,23,30,25,25,-0.166667,-5,0,0,0,0,36047018400,11214
184,2003,2,32,25,11,32,32,1.909091,21,0,0,0,0,36047018400,11214
184,2003,3,14,32,20,14,14,-0.3,-6,0,0,0,0,36047018400,11214
184,2003,4,21,14,19,21,21,0.105263,2,0,0,0,0,36047018400,11214
184,2003,5,19,21,18,19,19,0.055556,1,0,0,0,0,36047018400,11214
184,2004,0,20,20,23,26,26,-0.130435,-3,-0.230769,-6,-0.230769,-6,36047018400,11214
184,2004,1,25,20,25,13,13,0,0,0.923077,12,0.923077,12,36047018400,11214
184,2004,2,24,25,32,18,18,-0.25,-8,0.333333,6,0.333333,6,36047018400,11214
184,2004,3,31,24,14,16,16,1.214286,17,0.9375,15,0.9375,15,36047018400,11214
184,2004,4,15,31,21,22,22,-0.285714,-6,-0.318182,-7,-0.318182,-7,36047018400,11214
184,2004,5,28,15,19,11,11,0.473684,9,1.545455,17,1.545455,17,36047018400,11214
184,2005,0,22,22,20,27,27,0.1,2,-0.185185,-5,-0.185185,-5,36047018400,11214
184,2005,1,19,22,25,30,30,-0.24,-6,-0.366667,-11,-0.366667,-11,36047018400,11214
184,2005,2,23,19,24,11,11,-0.041667,-1,1.090909,12,1.090909,12,36047018400,11214
184,2005,3,26,23,31,20,20,-0.16129,-5,0.3,6,0.3,6,36047018400,11214
184,2005,4,30,26,15,19,19,1,15,0.578947,11,0.578947,11,36047018400,11214
184,2005,5,16,30,28,18,18,-0.428571,-12,-0.111111,-2,-0.111111,-2,36047018400,11214
184,2006,0,17,17,22,23,23,-0.227273,-5,-0.26087,-6,-0.26087,-6,36047018400,11214
184,2006,1,20,17,19,25,25,0.052632,1,-0.2,-5,-0.2,-5,36047018400,11214
184,2006,2,19,20,23,32,32,-0.173913,-4,-0.40625,-13,-0.40625,-13,36047018400,11214
184,2006,3,23,19,26,14,14,-0.115385,-3,0.642857,9,0.642857,9,36047018400,11214
184,2006,4,28,23,30,21,21,-0.066667,-2,0.333333,7,0.333333,7,36047018400,11214
184,2006,5,29,28,16,19,19,0.8125,13,0.526316,10,0.526316,10,36047018400,11214
184,2007,0,18,18,17,20,20,0.058824,1,-0.1,-2,-0.1,-2,36047018400,11214
184,2007,1,15,18,20,25,25,-0.25,-5,-0.4,-10,-0.4,-10,36047018400,11214
184,2007,2,24,15,19,24,24,0.263158,5,0,0,0,0,36047018400,11214
184,2007,3,23,24,23,31,31,0,0,-0.258065,-8,-0.258065,-8,36047018400,11214
184,2007,4,27,23,28,15,15,-0.035714,-1,0.8,12,0.8,12,36047018400,11214
184,2007,5,30,27,29,28,28,0.034483,1,0.071429,2,0.071429,2,36047018400,11214
184,2008,0,24,24,18,22,22,0.333333,6,0.090909,2,0.090909,2,36047018400,11214
184,2008,1,21,24,15,19,19,0.4,6,0.105263,2,0.105263,2,36047018400,11214
184,2008,2,14,21,24,23,23,-0.416667,-10,-0.391304,-9,-0.391304,-9,36047018400,11214
184,2008,3,25,14,23,26,26,0.086957,2,-0.038462,-1,-0.038462,-1,36047018400,11214
184,2008,4,28,25,27,30,30,0.037037,1,-0.066667,-2,-0.066667,-2,36047018400,11214
184,2008,5,30,28,30,16,16,0,0,0.875,14,0.875,14,36047018400,11214
184,2009,0,13,13,24,17,17,-0.458333,-11,-0.235294,-4,-0.235294,-4,36047018400,11214
184,2009,1,23,13,21,20,20,0.095238,2,0.15,3,0.15,3,36047018400,11214
184,2009,2,22,23,14,19,19,0.571429,8,0.157895,3,0.157895,3,36047018400,11214
184,2009,3,13,22,25,23,23,-0.48,-12,-0.434783,-10,-0.434783,-10,36047018400,11214
184,2009,4,26,13,28,28,28,-0.071429,-2,-0.071429,-2,-0.071429,-2,36047018400,11214
184,2009,5,29,26,30,29,29,-0.033333,-1,0,0,0,0,36047018400,11214
184,2010,0,17,17,13,18,18,0.307692,4,-0.055556,-1,-0.055556,-1,36047018400,11214
184,2010,1,18,17,23,15,15,-0.217391,-5,0.2,3,0.2,3,36047018400,11214
184,2010,2,24,18,22,24,24,0.090909,2,0,0,0,0,36047018400,11214
184,2010,3,22,24,13,23,23,0.692308,9,-0.043478,-1,-0.043478,-1,36047018400,11214
184,2010,4,16,22,26,27,27,-0.384615,-10,-0.407407,-11,-0.407407,-11,36047018400,11214
184,2010,5,27,16,29,30,30,-0.068966,-2,-0.1,-3,-0.1,-3,36047018400,11214
186,2001,0,23,23,23,23,23,0,0,0,0,0,0,36047018600,11214
186,2001,1,17,23,17,17,17,0,0,0,0,0,0,36047018600,11214
186,2001,2,18,17,18,18,18,0,0,0,0,0,0,36047018600,11214
186,2001,3,13,18,13,13,13,0,0,0,0,0,0,36047018600,11214
186,2001,4,23,13,23,23,23,0,0,0,0,0,0,36047018600,11214
186,2001,5,16,23,16,16,16,0,0,0,0,0,0,36047018600,11214
186,2002,0,26,26,23,26,26,0.130435,3,0,0,0,0,36047018600,11214
186,2002,1,20,26,17,20,20,0.176471,3,0,0,0,0,36047018600,11214
186,2002,2,19,20,18,19,19,0.055556,1,0,0,0,0,36047018600,11214
186,2002,3,16,19,13,16,16,0.230769,3,0,0,0,0,36047018600,11214
186,2002,4,12,16,23,12,12,-0.478261,-11,0,0,0,0,36047018600,11214
186,2002,5,24,12,16,24,24,0.5,8,0,0,0,0,36047018600,11214
186,2003,0,16,16,26,16,16,-0.384615,-10,0,0,0,0,36047018600,11214
186,2003,1,25,16,20,25,25,0.25,5,0,0,0,0,36047018600,11214
186,2003,2,21,25,19,21,21,0.105263,2,0,0,0,0,36047018600,11214
186,2003,3,20,21,16,20,20,0.25,4,0,0,0,0,36047018600,11214
186,2003,4,14,20,12,14,14,0.166667,2,0,0,0,0,36047018600,11214
186,2003,5,12,14,24,12,12,-0.5,-12,0,0,0,0,36047018600,11214
186,2004,0,20,20,16,23,23,0.25,4,-0.130435,-3,-0.130435,-3,36047018600,11214
186,2004,1,17,20,25,17,17,-0.32,-8,0,0,0,0,36047018600,11214
186,2004,2,24,17,21,18,18,0.142857,3,0.333333,6,0.333333,6,36047018600,11214
186,2004,3,18,24,20,13,13,-0.1,-2,0.384615,5,0.384615,5,36047018600,11214
186,2004,4,19,18,14,23,23,0.357143,5,-0.173913,-4,-0.173913,-4,36047018600,11214
186,2004,5,15,19,12,16,16,0.25,3,-0.0625,-1,-0.0625,-1,36047018600,11214
186,2005,0,19,19,20,26,26,-0.05,-1,-0.269231,-7,-0.269231,-7,36047018600,11214
186,2005,1,22,19,17,20,20,0.294118,5,0.1,2,0.1,2,36047018600,11214
186,2005,2,19,22,24,19,19,-0.208333,-5,0,0,0,0,36047018600,11214
186,2005,3,27,19,18,16,16,0.5,9,0.6875,11,0.6875,11,36047018600,11214
186,2005,4,22,27,19,12,12,0.157895,3,0.833333,10,0.833333,10,36047018600,11214
186,2005,5,18,22,15,24,24,0.2,3,-0.25,-6,-0.25,-6,36047018600,11214
186,2006,0,27,27,19,16,16,0.421053,8,0.6875,11,0.6875,11,36047018600,11214
186,2006,1,17,27,22,25,25,-0.227273,-5,-0.32,-8,-0.32,-8,36047018600,11214
186,2006,2,19,17,19,21,21,0,0,-0.095238,-2,-0.095238,-2,36047018600,11214
186,2006,3,18,19,27,20,20,-0.333333,-9,-0.1,-2,-0.1,-2,36047018600,11214
186,2006,4,24,18,22,14,14,0.090909,2,0.714286,10,0.714286,10,36047018600,11214
186,2006,5,23,24,18,12,12,0.277778,5,0.916667,11,0.916667,11,36047018600,11214
186,2007,0,23,23,27,20,20,-0.148148,-4,0.15,3,0.15,3,36047018600,11214
186,2007,1,26,23,17,17,17,0.529412,9,0.529412,9,0.529412,9,36047018600,11214
186,2007,2,18,26,19,24,24,-0.052632,-1,-0.25,-6,-0.25,-6,36047018600,11214
186,2007,3,23,18,18,18,18,0.277778,5,0.277778,5,0.277778,5,36047018600,11214
186,2007,4,19,23,24,19,19,-0.208333,-5,0,0,0,0,36047018600,11214
186,2007,5,22,19,23,15,15,-0.043478,-1,0.466667,7,0.466667,7,36047018600,11214
186,2008,0,19,19,23,19,19,-0.173913,-4,0,0,0,0,36047018600,11214
186,2008,1,26,19,26,22,22,0,0,0.181818,4,0.181818,4,36047018600,11214
186,2008,2,25,26,18,19,19,0.388889,7,0.315789,6,0.315789,6,36047018600,11214
186,2008,3,19,25,23,27,27,-0.173913,-4,-0.296296,-8,-0.296296,-8,36047018600,11214
186,2008,4,25,19,19,22,22,0.315789,6,0.136364,3,0.136364,3,36047018600,11214
186,2008,5,21,25,22,18,18,-0.045455,-1,0.166667,3,0.166667,3,36047018600,11214
186,2009,0,30,30,19,27,27,0.578947,11,0.111111,3,0.111111,3,36047018600,11214
186,2009,1,23,30,26,17,17,-0.115385,-3,0.352941,6,0.352941,6,36047018600,11214
186,2009,2,27,23,25,19,19,0.08,2,0.421053,8,0.421053,8,36047018600,11214
186,2009,3,20,27,19,18,18,0.052632,1,0.111111,2,0.111111,2,36047018600,11214
186,2009,4,22,20,25,24,24,-0.12,-3,-0.083333,-2,-0.083333,-2,36047018600,11214
186,2009,5,27,22,21,23,23,0.285714,6,0.173913,4,0.173913,4,36047018600,11214
186,2010,0,23,23,30,23,23,-0.233333,-7,0,0,0,0,36047018600,11214
186,2010,1,30,23,23,26,26,0.304348,7,0.153846,4,0.153846,4,36047018600,11214
186,2010,2,21,30,27,18,18,-0.222222,-6,0.166667,3,0.166667,3,36047018600,11214
186,2010,3,30,21,20,23,23,0.5,10,0.304348,7,0.304348,7,36047018600,11214
186,2010,4,25,30,22,19,19,0.136364,3,0.315789,6,0.315789,6,36047018600,11214
186,2010,5,20,25,27,22,22,-0.259259,-7,-0.090909,-2,-0.090909,-2,36047018600,11214
188,2001,0,11,11,11,11,11,0,0,0,0,0,0,36047018800,11204
188,2001,1,19,11,19,19,19,0,0,0,0,0,0,36047018800,11204
188,2001,2,28,19,28,28,28,0,0,0,0,0,0,36047018800,11204
188,2001,3,19,28,19,19,19,0,0,0,0,0,0,36047018800,11204
188,2001,4,16,19,16,16,16,0,0,0,0,0,0,36047018800,11204
188,2001,5,22,16,22,22,22,0,0,0,0,0,0,36047018800,11204
188,2002,0,12,12,11,12,12,0.090909,1,0,0,0,0,36047018800,11204
188,2002,1,17,12,19,17,17,-0.105263,-2,0,0,0,0,36047018800,11204
188,2002,2,21,17,28,21,21,-0.25,-7,0,0,0,0,36047018800,11204
188,2002,3,29,21,19,29,29,0.526316,10,0,0,0,0,36047018800,11204
188,2002,4,19,29,16,19,19,0.1875,3,0,0,0,0,36047018800,11204
188,2002,5,20,19,22,20,20,-0.090909,-2,0,0,0,0,36047018800,11204
188,2003,0,18,18,12,18,18,0.5,6,0,0,0,0,36047018800,11204
188,2003,1,13,18,17,13,13,-0.235294,-4,0,0,0,0,36047018800,11204
188,2003,2,19,13,21,19,19,-0.095238,-2,0,0,0,0,36047018800,11204
188,2003,3,25,19,29,25,25,-0.137931,-4,0,0,0,0,36047018800,11204
188,2003,4,27,25,19,27,27,0.421053,8,0,0,0,0,36047018800,11204
188,2003,5,23,27,20,23,23,0.15,3,0,0,0,0,36047018800,11204
188,2004,0,16,16,18,11,11,-0.111111,-2,0.454545,5,0.454545,5,36047018800,11204
188,2004,1,21,16,13,19,19,0.615385,8,0.105263,2,0.105263,2,36047018800,11204
188,2004,2,10,21,19,28,28,-0.473684,-9,-0.642857,-18,-0.642857,-18,36047018800,11204
188,2004,3,26,10,25,19,19,0.04,1,0.368421,7,0.368421,7,36047018800,11204
188,2004,4,25,26,27,16,16,-0.074074,-2,0.5625,9,0.5625,9,36047018800,11204
188,2004,5,27,25,23,22,22,0.173913,4,0.227273,5,0.227273,5,36047018800,11204
188,2005,0,21,21,16,12,12,0.3125,5,0.75,9,0.75,9,36047018800,11204
188,2005,1,17,21,21,17,17,-0.190476,-4,0,0,0,0,36047018800,11204
188,2005,2,20,17,10,21,21,1,10,-0.047619,-1,-0.047619,-1,36047018800,11204
188,2005,3,9,20,26,29,29,-0.653846,-17,-0.689655,-20,-0.689655,-20,36047018800,11204
188,2005,4,24,9,25,19,19,-0.04,-1,0.263158,5,0.263158,5,36047018800,11204
188,2005,5,20,24,27,20,20,-0.259259,-7,0,0,0,0,36047018800,11204
188,2006,0,18,18,21,18,18,-0.142857,-3,0,0,0,0,36047018800,11204
188,2006,1,25,18,17,13,13,0.470588,8,0.923077,12,0.923077,12,36047018800,11204
188,2006,2,16,25,20,19,19,-0.2,-4,-0.157895,-3,-0.157895,-3,36047018800,11204
188,2006,3,17,16,9,25,25,0.888889,8,-0.32,-8,-0.32,-8,36047018800,11204
188,2006,4,16,17,24,27,27,-0.333333,-8,-0.407407,-11,-0.407407,-11,36047018800,11204
188,2006,5,22,16,20,23,23,0.1,2,-0.043478,-1,-0.043478,-1,36047018800,11204
188,2007,0,22,22,18,16,16,0.222222,4,0.375,6,0.375,6,36047018800,11204
188,2007,1,19,22,25,21,21,-0.24,-6,-0.095238,-2,-0.095238,-2,36047018800,11204
188,2007,2,27,19,16,10,10,0.6875,11,1.7,17,1.7,17,36047018800,11204
188,2007,3,16,27,17,26,26,-0.058824,-1,-0.384615,-10,-0.384615,-10,36047018800,11204
188,2007,4,21,16,16,25,25,0.3125,5,-0.16,-4,-0.16,-4,36047018800,11204
188,2007,5,13,21,22,27,27,-0.409091,-9,-0.518519,-14,-0.518519,-14,36047018800,11204
188,2008,0,17,17,22,21,21,-0.227273,-5,-0.190476,-4,-0.190476,-4,36047018800,11204
188,2008,1,23,17,19,17,17,0.210526,4,0.352941,6,0.352941,6,36047018800,11204
188,2008,2,19,23,27,20,20,-0.296296,-8,-0.05,-1,-0.05,-1,36047018800,11204
188,2008,3,27,19,16,9,9,0.6875,11,2,18,2,18,36047018800,11204
188,2008,4,16,27,21,24,24,-0.238095,-5,-0.333333,-8,-0.333333,-8,36047018800,11204
188,2008,5,22,16,13,20,20,0.692308,9,0.1,2,0.1,2,36047018800,11204
188,2009,0,19,19,17,18,18,0.117647,2,0.055556,1,0.055556,1,36047018800,11204
188,2009,1,20,19,23,25,25,-0.130435,-3,-0.2,-5,-0.2,-5,36047018800,11204
188,2009,2,29,20,19,16,16,0.526316,10,0.8125,13,0.8125,13,36047018800,11204
188,2009,3,22,29,27,17,17,-0.185185,-5,0.294118,5,0.294118,5,36047018800,11204
188,2009,4,28,22,16,16,16,0.75,12,0.75,12,0.75,12,36047018800,11204
188,2009,5,16,28,22,22,22,-0.272727,-6,-0.272727,-6,-0.272727,-6,36047018800,11204
188,2010,0,33,33,19,22,22,0.736842,14,0.5,11,0.5,11,36047018800,11204
188,2010,1,19,33,20,19,19,-0.05,-1,0,0,0,0,36047018800,11204
188,2010,2,15,19,29,27,27,-0.482759,-14,-0.444444,-12,-0.444444,-12,36047018800,11204
188,2010,3,32,15,22,16,16,0.454545,10,1,16,1,16,36047018800,11204
188,2010,4,19,32,28,21,21,-0.321429,-9,-0.095238,-2,-0.095238,-2,36047018800,11204
188,2010,5,24,19,16,13,13,0.5,8,0.846154,11,0.846154,11,36047018800,11204
190,2001,0,45,45,45,45,45,0,0,0,0,0,0,36047019000,11204
190,2001,1,45,45,45,45,45,0,0,0,0,0,0,36047019000,11204
190,2001,2,42,45,42,42,42,0,0,0,0,0,0,36047019000,11204
190,2001,3,43,42,43,43,43,0,0,0,0,0,0,36047019000,11204
190,2001,4,43,43,43,43,43,0,0,0,0,0,0,36047019000,11204
190,2001,5,54,43,54,54,54,0,0,0,0,0,0,36047019000,11204
190,2002,0,36,36,45,36,36,-0.2,-9,0,0,0,0,36047019000,11204
190,2002,1,51,36,45,51,51,0.133333,6,0,0,0,0,36047019000,11204
190,2002,2,45,51,42,45,45,0.071429,3,0,0,0,0,36047019000,11204
190,2002,3,39,45,43,39,39,-0.093023,-4,0,0,0,0,36047019000,11204
190,2002,4,33,39,43,33,33,-0.232558,-10,0,0,0,0,36047019000,11204
190,2002,5,44,33,54,44,44,-0.185185,-10,0,0,0,0,36047019000,11204
190,2003,0,33,33,36,33,33,-0.083333,-3,0,0,0,0,36047019000,11204
190,2003,1,39,33,51,39,39,-0.235294,-12,0,0,0,0,36047019000,11204
190,2003,2,46,39,45,46,46,0.022222,1,0,0,0,0,36047019000,11204
190,2003,3,48,46,39,48,48,0.230769,9,0,0,0,0,36047019000,11204
190,2003,4,39,48,33,39,39,0.181818,6,0,0,0,0,36047019000,11204
190,2003,5,29,39,44,29,29,-0.340909,-15,0,0,0,0,36047019000,11204
190,2004,0,40,40,33,45,45,0.212121,7,-0.111111,-5,-0.111111,-5,36047019000,11204
190,2004,1,36,40,39,45,45,-0.076923,-3,-0.2,-9,-0.2,-9,36047019000,11204
190,2004,2,38,36,46,42,42,-0.173913,-8,-0.095238,-4,-0.095238,-4,36047019000,11204
190,2004,3,48,38,48,43,43,0,0,0.116279,5,0.116279,5,36047019000,11204
190,2004,4,49,48,39,43,43,0.25641,10,0.139535,6,0.139535,6,36047019000,11204
190,2004,5,44,49,29,54,54,0.517241,15,-0.185185,-10,-0.185185,-10,36047019000,11204
190,2005,0,41,41,40,36,36,0.025,1,0.138889,5,0.138889,5,36047019000,11204
190,2005,1,35,41,36,51,51,-0.027778,-1,-0.313725,-16,-0.313725,-16,36047019000,11204
190,2005,2,37,35,38,45,45,-0.026316,-1,-0.177778,-8,-0.177778,-8,36047019000,11204
190,2005,3,31,37,48,39,39,-0.354167,-17,-0.205128,-8,-0.205128,-8,36047019000,11204
190,2005,4,41,31,49,33,33,-0.163265,-8,0.242424,8,0.242424,8,36047019000,11204
190,2005,5,43,41,44,44,44,-0.022727,-1,-0.022727,-1,-0.022727,-1,36047019000,11204
190,2006,0,41,41,41,33,33,0,0,0.242424,8,0.242424,8,36047019000,11204
190,2006,1,45,41,35,39,39,0.285714,10,0.153846,6,0.153846,6,36047019000,11204
190,2006,2,39,45,37,46,46,0.054054,2,-0.152174,-7,-0.152174,-7,36047019000,11204
190,2006,3,41,39,31,48,48,0.322581,10,-0.145833,-7,-0.145833,-7,36047019000,11204
190,2006,4,31,41,41,39,39,-0.243902,-10,-0.205128,-8,-0.205128,-8,36047019000,11204
190,2006,5,36,31,43,29,29,-0.162791,-7,0.241379,7,0.241379,7,36047019000,11204
190,2007,0,54,54,41,40,40,0.317073,13,0.35,14,0.35,14,36047019000,11204
190,2007,1,47,54,45,36,36,0.044444,2,0.305556,11,0.305556,11,36047019000,11204
190,2007,2,45,47,39,38,38,0.153846,6,0.184211,7,0.184211,7,36047019000,11204
190,2007,3,38,45,41,48,48,-0.073171,-3,-0.208333,-10,-0.208333,-10,36047019000,11204
190,2007,4,43,38,31,49,49,0.387097,12,-0.122449,-6,-0.122449,-6,36047019000,11204
190,2007,5,29,43,36,44,44,-0.194444,-7,-0.340909,-15,-0.340909,-15,36047019000,11204
190,2008,0,40,40,54,41,41,-0.259259,-14,-0.02439,-1,-0.02439,-1,36047019000,11204
190,2008,1,52,40,47,35,35,0.106383,5,0.485714,17,0.485714,17,36047019000,11204
190,2008,2,48,52,45,37,37,0.066667,3,0.297297,11,0.297297,11,36047019000,11204
190,2008,3,48,48,38,31,31,0.263158,10,0.548387,17,0.548387,17,36047019000,11204
190,2008,4,35,48,43,41,41,-0.186047,-8,-0.146341,-6,-0.146341,-6,36047019000,11204
190,2008,5,42,35,29,43,43,0.448276,13,-0.023256,-1,-0.023256,-1,36047019000,11204
190,2009,0,45,45,40,41,41,0.125,5,0.097561,4,0.097561,4,36047019000,11204
190,2009,1,46,45,52,45,45,-0.115385,-6,0.022222,1,0.022222,1,36047019000,11204
190,2009,2,58,46,48,39,39,0.208333,10,0.487179,19,0.487179,19,36047019000,11204
190,2009,3,53,58,48,41,41,0.104167,5,0.292683,12,0.292683,12,36047019000,11204
190,2009,4,57,53,35,31,31,0.628571,22,0.83871,26,0.83871,26,36047019000,11204
190,2009,5,44,57,42,36,36,0.047619,2,0.222222,8,0.222222,8,36047019000,11204
190,2010,0,52,52,45,54,54,0.155556,7,-0.037037,-2,-0.037037,-2,36047019000,11204
190,2010,1,50,52,46,47,47,0.086957,4,0.06383,3,0.06383,3,36047019000,11204
190,2010,2,42,50,58,45,45,-0.275862,-16,-0.066667,-3,-0.066667,-3,36047019000,11204
190,2010,3,63,42,53,38,38,0.188679,10,0.657895,25,0.657895,25,36047019000,11204
190,2010,4,49,63,57,43,43,-0.140351,-8,0.139535,6,0.139535,6,36047019000,11204
190,2010,5,58,49,44,29,29,0.318182,14,1,29,1,29,36047019000,11204
192,2001,0,19,19,19,19,19,0,0,0,0,0,0,36047019200,11219
192,2001,1,15,19,15,15,15,0,0,0,0,0,0,36047019200,11219
192,2001,2,22,15,22,22,22,0,0,0,0,0,0,36047019200,11219
192,2001,3,18,22,18,18,18,0,0,0,0,0,0,36047019200,11219
192,2001,4,11,18,11,11,11,0,0,0,0,0,0,36047019200,11219
192,2001,5,19,11,19,19,19,0,0,0,0,0,0,36047019200,11219
192,2002,0,15,15,19,15,15,-0.210526,-4,0,0,0,0,36047019200,11219
192,2002,1,19,15,15,19,19,0.266667,4,0,0,0,0,36047019200,11219
192,2002,2,18,19,22,18,18,-0.181818,-4,0,0,0,0,36047019200,11219
192,2002,3,27,18,18,27,27,0.5,9,0,0,0,0,36047019200,11219
192,2002,4,19,27,11,19,19,0.727273,8,0,0,0,0,36047019200,11219
192,2002,5,14,19,19,14,14,-0.263158,-5,0,0,0,0,36047019200,11219
192,2003,0,16,16,15,16,16,0.066667,1,0,0,0,0,36047019200,11219
192,2003,1,12,16,19,12,12,-0.368421,-7,0,0,0,0,36047019200,11219
192,2003,2,21,12,18,21,21,0.166667,3,0,0,0,0,36047019200,11219
192,2003,3,17,21,27,17,17,-0.37037,-10,0,0,0,0,36047019200,11219
192,2003,4,25,17,19,25,25,0.315789,6,0,0,0,0,36047019200,11219
192,2003,5,15,25,14,15,15,0.071429,1,0,0,0,0,36047019200,11219
192,2004,0,20,20,16,19,19,0.25,4,0.052632,1,0.052632,1,36047019200,11219
192,2004,1,16,20,12,15,15,0.333333,4,0.066667,1,0.066667,1,36047019200,11219
192,2004,2,12,16,21,22,22,-0.428571,-9,-0.454545,-10,-0.454545,-10,36047019200,11219
192,2004,3,19,12,17,18,18,0.117647,2,0.055556,1,0.055556,1,36047019200,11219
192,2004,4,22,19,25,11,11,-0.12,-3,1,11,1,11,36047019200,11219
192,2004,5,22,22,15,19,19,0.466667,7,0.157895,3,0.157895,3,36047019200,11219
192,2005,0,6,6,20,15,15,-0.7,-14,-0.6,-9,-0.6,-9,36047019200,11219
192,2005,1,24,6,16,19,19,0.5,8,0.263158,5,0.263158,5,36047019200,11219
192,2005,2,17,24,12,18,18,0.416667,5,-0.055556,-1,-0.055556,-1,36047019200,11219
192,2005,3,11,17,19,27,27,-0.421053,-8,-0.592593,-16,-0.592593,-16,36047019200,11219
192,2005,4,21,11,22,19,19,-0.045455,-1,0.105263,2,0.105263,2,36047019200,11219
192,2005,5,23,21,22,14,14,0.045455,1,0.642857,9,0.642857,9,36047019200,11219
192,2006,0,10,10,6,16,16,0.666667,4,-0.375,-6,-0.375,-6,36047019200,11219
192,2006,1,6,10,24,12,12,-0.75,-18,-0.5,-6,-0.5,-6,36047019200,11219
192,2006,2,21,6,17,21,21,0.235294,4,0,0,0,0,36047019200,11219
192,2006,3,16,21,11,17,17,0.454545,5,-0.058824,-1,-0.058824,-1,36047019200,11219
192,2006,4,12,16,21,25,25,-0.428571,-9,-0.52,-13,-0.52,-13,36047019200,11219
192,2006,5,19,12,23,15,15,-0.173913,-4,0.266667,4,0.266667,4,36047019200,11219
192,2007,0,13,13,10,20,20,0.3,3,-0.35,-7,-0.35,-7,36047019200,11219
192,2007,1,13,13,6,16,16,1.166667,7,-0.1875,-3,-0.1875,-3,36047019200,11219
192,2007,2,9,13,21,12,12,-0.571429,-12,-0.25,-3,-0.25,-3,36047019200,11219
192,2007,3,23,9,16,19,19,0.4375,7,0.210526,4,0.210526,4,36047019200,11219
192,2007,4,15,23,12,22,22,0.25,3,-0.318182,-7,-0.318182,-7,36047019200,11219
192,2007,5,12,15,19,22,22,-0.368421,-7,-0.454545,-10,-0.454545,-10,36047019200,11219
192,2008,0,18,18,13,6,6,0.384615,5,2,12,2,12,36047019200,11219
192,2008,1,14,18,13,24,24,0.076923,1,-0.416667,-10,-0.416667,-10,36047019200,11219
192,2008,2,13,14,9,17,17,0.444444,4,-0.235294,-4,-0.235294,-4,36047019200,11219
192,2008,3,9,13,23,11,11,-0.608696,-14,-0.181818,-2,-0.181818,-2,36047019200,11219
192,2008,4,20,9,15,21,21,0.333333,5,-0.047619,-1,-0.047619,-1,36047019200,11219
192,2008,5,12,20,12,23,23,0,0,-0.478261,-11,-0.478261,-11,36047019200,11219
192,2009,0,22,22,18,10,10,0.222222,4,1.2,12,1.2,12,36047019200,11219
192,2009,1,16,22,14,6,6,0.142857,2,1.666667,10,1.666667,10,36047019200,11219
192,2009,2,15,16,13,21,21,0.153846,2,-0.285714,-6,-0.285714,-6,36047019200,11219
192,2009,3,13,15,9,16,16,0.444444,4,-0.1875,-3,-0.1875,-3,36047019200,11219
192,2009,4,13,13,20,12,12,-0.35,-7,0.083333,1,0.083333,1,36047019200,11219
192,2009,5,15,13,12,19,19,0.25,3,-0.210526,-4,-0.210526,-4,36047019200,11219
192,2010,0,22,22,22,13,13,0,0,0.692308,9,0.692308,9,36047019200,11219
192,2010,1,23,22,16,13,13,0.4375,7,0.769231,10,0.769231,10,36047019200,11219
192,2010,2,17,23,15,9,9,0.133333,2,0.888889,8,0.888889,8,36047019200,11219
192,2010,3,19,17,13,23,23,0.461538,6,-0.173913,-4,-0.173913,-4,36047019200,11219
192,2010,4,15,19,13,15,15,0.153846,2,0,0,0,0,36047019200,11219
192,2010,5,16,15,15,12,12,0.066667,1,0.333333,4,0.333333,4,36047019200,11219
194,2001,0,25,25,25,25,25,0,0,0,0,0,0,36047019400,11219
194,2001,1,25,25,25,25,25,0,0,0,0,0,0,36047019400,11219
194,2001,2,36,25,36,36,36,0,0,0,0,0,0,36047019400,11219
194,2001,3,26,36,26,26,26,0,0,0,0,0,0,36047019400,11219
194,2001,4,32,26,32,32,32,0,0,0,0,0,0,36047019400,11219
194,2001,5,30,32,30,30,30,0,0,0,0,0,0,36047019400,11219
194,2002,0,37,37,25,37,37,0.48,12,0,0,0,0,36047019400,11219
194,2002,1,32,37,25,32,32,0.28,7,0,0,0,0,36047019400,11219
194,2002,2,25,32,36,25,25,-0.305556,-11,0,0,0,0,36047019400,11219
194,2002,3,37,25,26,37,37,0.423077,11,0,0,0,0,36047019400,11219
194,2002,4,23,37,32,23,23,-0.28125,-9,0,0,0,0,36047019400,11219
194,2002,5,31,23,30,31,31,0.033333,1,0,0,0,0,36047019400,11219
194,2003,0,31,31,37,31,31,-0.162162,-6,0,0,0,0,36047019400,11219
194,2003,1,39,31,32,39,39,0.21875,7,0,0,0,0,36047019400,11219
194,2003,2,32,39,25,32,32,0.28,7,0,0,0,0,36047019400,11219
194,2003,3,22,32,37,22,22,-0.405405,-15,0,0,0,0,36047019400,11219
194,2003,4,40,22,23,40,40,0.73913,17,0,0,0,0,36047019400,11219
194,2003,5,24,40,31,24,24,-0.225806,-7,0,0,0,0,36047019400,11219
194,2004,0,28,28,31,25,25,-0.096774,-3,0.12,3,0.12,3,36047019400,11219
194,2004,1,34,28,39,25,25,-0.128205,-5,0.36,9,0.36,9,36047019400,11219
194,2004,2,34,34,32,36,36,0.0625,2,-0.055556,-2,-0.055556,-2,36047019400,11219
194,2004,3,24,34,22,26,26,0.090909,2,-0.076923,-2,-0.076923,-2,36047019400,11219
194,2004,4,21,24,40,32,32,-0.475,-19,-0.34375,-11,-0.34375,-11,36047019400,11219
194,2004,5,39,21,24,30,30,0.625,15,0.3,9,0.3,9,36047019400,11219
194,2005,0,21,21,28,37,37,-0.25,-7,-0.432432,-16,-0.432432,-16,36047019400,11219
194,2005,1,25,21,34,32,32,-0.264706,-9,-0.21875,-7,-0.21875,-7,36047019400,11219
194,2005,2,32,25,34,25,25,-0.058824,-2,0.28,7,0.28,7,36047019400,11219
194,2005,3,31,32,24,37,37,0.291667,7,-0.162162,-6,-0.162162,-6,36047019400,11219
194,2005,4,20,31,21,23,23,-0.047619,-1,-0.130435,-3,-0.130435,-3,36047019400,11219
194,2005,5,25,20,39,31,31,-0.358974,-14,-0.193548,-6,-0.193548,-6,36047019400,11219
194,2006,0,22,22,21,31,31,0.047619,1,-0.290323,-9,-0.290323,-9,36047019400,11219
194,2006,1,23,22,25,39,39,-0.08,-2,-0.410256,-16,-0.410256,-16,36047019400,11219
194,2006,2,23,23,32,32,32,-0.28125,-9,-0.28125,-9,-0.28125,-9,36047019400,11219
194,2006,3,33,23,31,22,22,0.064516,2,0.5,11,0.5,11,36047019400,11219
194,2006,4,32,33,20,40,40,0.6,12,-0.2,-8,-0.2,-8,36047019400,11219
194,2006,5,19,32,25,24,24,-0.24,-6,-0.208333,-5,-0.208333,-5,36047019400,11219
194,2007,0,21,21,22,28,28,-0.045455,-1,-0.25,-7,-0.25,-7,36047019400,11219
194,2007,1,23,21,23,34,34,0,0,-0.323529,-11,-0.323529,-11,36047019400,11219
194,2007,2,26,23,23,34,34,0.130435,3,-0.235294,-8,-0.235294,-8,36047019400,11219
194,2007,3,27,26,33,24,24,-0.181818,-6,0.125,3,0.125,3,36047019400,11219
194,2007,4,32,27,32,21,21,0,0,0.52381,11,0.52381,11,36047019400,11219
194,2007,5,28,32,19,39,39,0.473684,9,-0.282051,-11,-0.282051,-11,36047019400,11219
194,2008,0,35,35,21,21,21,0.666667,14,0.666667,14,0.666667,14,36047019400,11219
194,2008,1,24,35,23,25,25,0.043478,1,-0.04,-1,-0.04,-1,36047019400,11219
194,2008,2,26,24,26,32,32,0,0,-0.1875,-6,-0.1875,-6,36047019400,11219
194,2008,3,28,26,27,31,31,0.037037,1,-0.096774,-3,-0.096774,-3,36047019400,11219
194,2008,4,30,28,32,20,20,-0.0625,-2,0.5,10,0.5,10,36047019400,11219
194,2008,5,38,30,28,25,25,0.357143,10,0.52,13,0.52,13,36047019400,11219
194,2009,0,50,50,35,22,22,0.428571,15,1.272727,28,1.272727,28,36047019400,11219
194,2009,1,36,50,24,23,23,0.5,12,0.565217,13,0.565217,13,36047019400,11219
194,2009,2,29,36,26,23,23,0.115385,3,0.26087,6,0.26087,6,36047019400,11219
194,2009,3,28,29,28,33,33,0,0,-0.151515,-5,-0.151515,-5,36047019400,11219
194,2009,4,41,28,30,32,32,0.366667,11,0.28125,9,0.28125,9,36047019400,11219
194,2009,5,37,41,38,19,19,-0.026316,-1,0.947368,18,0.947368,18,36047019400,11219
194,2010,0,29,29,50,21,21,-0.42,-21,0.380952,8,0.380952,8,36047019400,11219
194,2010,1,44,29,36,23,23,0.222222,8,0.913043,21,0.913043,21,36047019400,11219
194,2010,2,37,44,29,26,26,0.275862,8,0.423077,11,0.423077,11,36047019400,11219
194,2010,3,28,37,28,27,27,0,0,0.037037,1,0.037037,1,36047019400,11219
194,2010,4,28,28,41,32,32,-0.317073,-13,-0.125,-4,-0.125,-4,36047019400,11219
194,2010,5,37,28,37,28,28,0,0,0.321429,9,0.321429,9,36047019400,11219
196,2001,0,32,32,32,32,32,0,0,0,0,0,0,36047019600,11219
196,2001,1,32,32,32,32,32,0,0,0,0,0,0,36047019600,11219
196,2001,2,42,32,42,42,42,0,0,0,0,0,0,36047019600,11219
196,2001,3,32,42,32,32,32,0,0,0,0,0,0,36047019600,11219
196,2001,4,35,32,35,35,35,0,0,0,0,0,0,36047019600,11219
196,2001,5,47,35,47,47,47,0,0,0,0,0,0,36047019600,11219
196,2002,0,23,23,32,23,23,-0.28125,-9,0,0,0,0,36047019600,11219
196,2002,1,41,23,32,41,41,0.28125,9,0,0,0,0,36047019600,11219
196,2002,2,38,41,42,38,38,-0.095238,-4,0,0,0,0,36047019600,11219
196,2002,3,48,38,32,48,48,0.5,16,0,0,0,0,36047019600,11219
196,2002,4,36,48,35,36,36,0.028571,1,0,0,0,0,36047019600,11219
196,2002,5,34,36,47,34,34,-0.276596,-13,0,0,0,0,36047019600,11219
196,2003,0,30,30,23,30,30,0.304348,7,0,0,0,0,36047019600,11219
196,2003,1,28,30,41,28,28,-0.317073,-13,0,0,0,0,36047019600,11219
196,2003,2,39,28,38,39,39,0.026316,1,0,0,0,0,36047019600,11219
196,2003,3,38,39,48,38,38,-0.208333,-10,0,0,0,0,36047019600,11219
196,2003,4,43,38,36,43,43,0.194444,7,0,0,0,0,36047019600,11219
196,2003,5,45,43,34,45,45,0.323529,11,0,0,0,0,36047019600,11219
196,2004,0,26,26,30,32,32,-0.133333,-4,-0.1875,-6,-0.1875,-6,36047019600,11219
196,2004,1,32,26,28,32,32,0.142857,4,0,0,0,0,36047019600,11219
196,2004,2,29,32,39,42,42,-0.25641,-10,-0.309524,-13,-0.309524,-13,36047019600,11219
196,2004,3,34,29,38,32,32,-0.105263,-4,0.0625,2,0.0625,2,36047019600,11219
196,2004,4,40,34,43,35,35,-0.069767,-3,0.142857,5,0.142857,5,36047019600,11219
196,2004,5,42,40,45,47,47,-0.066667,-3,-0.106383,-5,-0.106383,-5,36047019600,11219
196,2005,0,33,33,26,23,23,0.269231,7,0.434783,10,0.434783,10,36047019600,11219
196,2005,1,26,33,32,41,41,-0.1875,-6,-0.365854,-15,-0.365854,-15,36047019600,11219
196,2005,2,32,26,29,38,38,0.103448,3,-0.157895,-6,-0.157895,-6,36047019600,11219
196,2005,3,29,32,34,48,48,-0.147059,-5,-0.395833,-19,-0.395833,-19,36047019600,11219
196,2005,4,40,29,40,36,36,0,0,0.111111,4,0.111111,4,36047019600,11219
196,2005,5,46,40,42,34,34,0.095238,4,0.352941,12,0.352941,12,36047019600,11219
196,2006,0,32,32,33,30,30,-0.030303,-1,0.066667,2,0.066667,2,36047019600,11219
196,2006,1,34,32,26,28,28,0.307692,8,0.214286,6,0.214286,6,36047019600,11219
196,2006,2,31,34,32,39,39,-0.03125,-1,-0.205128,-8,-0.205128,-8,36047019600,11219
196,2006,3,30,31,29,38,38,0.034483,1,-0.210526,-8,-0.210526,-8,36047019600,11219
196,2006,4,29,30,40,43,43,-0.275,-11,-0.325581,-14,-0.325581,-14,36047019600,11219
196,2006,5,40,29,46,45,45,-0.130435,-6,-0.111111,-5,-0.111111,-5,36047019600,11219
196,2007,0,37,37,32,26,26,0.15625,5,0.423077,11,0.423077,11,36047019600,11219
196,2007,1,33,37,34,32,32,-0.029412,-1,0.03125,1,0.03125,1,36047019600,11219
196,2007,2,30,33,31,29,29,-0.032258,-1,0.034483,1,0.034483,1,36047019600,11219
196,2007,3,23,30,30,34,34,-0.233333,-7,-0.323529,-11,-0.323529,-11,36047019600,11219
196,2007,4,30,23,29,40,40,0.034483,1,-0.25,-10,-0.25,-10,36047019600,11219
196,2007,5,26,30,40,42,42,-0.35,-14,-0.380952,-16,-0.380952,-16,36047019600,11219
196,2008,0,39,39,37,33,33,0.054054,2,0.181818,6,0.181818,6,36047019600,11219
196,2008,1,37,39,33,26,26,0.121212,4,0.423077,11,0.423077,11,36047019600,11219
196,2008,2,36,37,30,32,32,0.2,6,0.125,4,0.125,4,36047019600,11219
196,2008,3,43,36,23,29,29,0.869565,20,0.482759,14,0.482759,14,36047019600,11219
196,2008,4,27,43,30,40,40,-0.1,-3,-0.325,-13,-0.325,-13,36047019600,11219
196,2008,5,38,27,26,46,46,0.461538,12,-0.173913,-8,-0.173913,-8,36047019600,11219
196,2009,0,55,55,39,32,32,0.410256,16,0.71875,23,0.71875,23,36047019600,11219
196,2009,1,45,55,37,34,34,0.216216,8,0.323529,11,0.323529,11,36047019600,11219
196,2009,2,43,45,36,31,31,0.194444,7,0.387097,12,0.387097,12,36047019600,11219
196,2009,3,50,43,43,30,30,0.162791,7,0.666667,20,0.666667,20,36047019600,11219
196,2009,4,51,50,27,29,29,0.888889,24,0.758621,22,0.758621,22,36047019600,11219
196,2009,5,40,51,38,40,40,0.052632,2,0,0,0,0,36047019600,11219
196,2010,0,41,41,55,37,37,-0.254545,-14,0.108108,4,0.108108,4,36047019600,11219
196,2010,1,61,41,45,33,33,0.355556,16,0.848485,28,0.848485,28,36047019600,11219
196,2010,2,53,61,43,30,30,0.232558,10,0.766667,23,0.766667,23,36047019600,11219
196,2010,3,50,53,50,23,23,0,0,1.173913,27,1.173913,27,36047019600,11219
196,2010,4,55,50,51,30,30,0.078431,4,0.833333,25,0.833333,25,36047019600,11219
196,2010,5,57,55,40,26,26,0.425,17,1.192308,31,1.192308,31,36047019600,11219
198,2001,0,15,15,15,15,15,0,0,0,0,0,0,36047019800,11228
198,2001,1,11,15,11,11,11,0,0,0,0,0,0,36047019800,11228
198,2001,2,12,11,12,12,12,0,0,0,0,0,0,36047019800,11228
198,2001,3,13,12,13,13,13,0,0,0,0,0,0,36047019800,11228
198,2001,4,14,13,14,14,14,0,0,0,0,0,0,36047019800,11228
198,2001,5,9,14,9,9,9,0,0,0,0,0,0,36047019800,11228
198,2002,0,6,6,15,6,6,-0.6,-9,0,0,0,0,36047019800,11228
198,2002,1,16,6,11,16,16,0.454545,5,0,0,0,0,36047019800,11228
198,2002,2,11,16,12,11,11,-0.083333,-1,0,0,0,0,36047019800,11228
198,2002,3,12,11,13,12,12,-0.076923,-1,0,0,0,0,36047019800,11228
198,2002,4,13,12,14,13,13,-0.071429,-1,0,0,0,0,36047019800,11228
198,2002,5,14,13,9,14,14,0.555556,5,0,0,0,0,36047019800,11228
198,2003,0,19,19,6,19,19,2.166667,13,0,0,0,0,36047019800,11228
198,2003,1,9,19,16,9,9,-0.4375,-7,0,0,0,0,36047019800,11228
198,2003,2,16,9,11,16,16,0.454545,5,0,0,0,0,36047019800,11228
198,2003,3,13,16,12,13,13,0.083333,1,0,0,0,0,36047019800,11228
198,2003,4,12,13,13,12,12,-0.076923,-1,0,0,0,0,36047019800,11228
198,2003,5,14,12,14,14,14,0,0,0,0,0,0,36047019800,11228
198,2004,0,15,15,19,15,15,-0.210526,-4,0,0,0,0,36047019800,11228
198,2004,1,15,15,9,11,11,0.666667,6,0.363636,4,0.363636,4,36047019800,11228
198,2004,2,8,15,16,12,12,-0.5,-8,-0.333333,-4,-0.333333,-4,36047019800,11228
198,2004,3,14,8,13,13,13,0.076923,1,0.076923,1,0.076923,1,36047019800,11228
198,2004,4,8,14,12,14,14,-0.333333,-4,-0.428571,-6,-0.428571,-6,36047019800,11228
198,2004,5,15,8,14,9,9,0.071429,1,0.666667,6,0.666667,6,36047019800,11228
198,2005,0,8,8,15,6,6,-0.466667,-7,0.333333,2,0.333333,2,36047019800,11228
198,2005,1,14,8,15,16,16,-0.066667,-1,-0.125,-2,-0.125,-2,36047019800,11228
198,2005,2,15,14,8,11,11,0.875,7,0.363636,4,0.363636,4,36047019800,11228
198,2005,3,8,15,14,12,12,-0.428571,-6,-0.333333,-4,-0.333333,-4,36047019800,11228
198,2005,4,14,8,8,13,13,0.75,6,0.076923,1,0.076923,1,36047019800,11228
198,2005,5,9,14,15,14,14,-0.4,-6,-0.357143,-5,-0.357143,-5,36047019800,11228
198,2006,0,16,16,8,19,19,1,8,-0.157895,-3,-0.157895,-3,36047019800,11228
198,2006,1,10,16,14,9,9,-0.285714,-4,0.111111,1,0.111111,1,36047019800,11228
198,2006,2,15,10,15,16,16,0,0,-0.0625,-1,-0.0625,-1,36047019800,11228
198,2006,3,12,15,8,13,13,0.5,4,-0.076923,-1,-0.076923,-1,36047019800,11228
198,2006,4,9,12,14,12,12,-0.357143,-5,-0.25,-3,-0.25,-3,36047019800,11228
198,2006,5,15,9,9,14,14,0.666667,6,0.071429,1,0.071429,1,36047019800,11228
198,2007,0,14,14,16,15,15,-0.125,-2,-0.066667,-1,-0.066667,-1,36047019800,11228
198,2007,1,17,14,10,15,15,0.7,7,0.133333,2,0.133333,2,36047019800,11228
198,2007,2,13,17,15,8,8,-0.133333,-2,0.625,5,0.625,5,36047019800,11228
198,2007,3,13,13,12,14,14,0.083333,1,-0.071429,-1,-0.071429,-1,36047019800,11228
198,2007,4,12,13,9,8,8,0.333333,3,0.5,4,0.5,4,36047019800,11228
198,2007,5,10,12,15,15,15,-0.333333,-5,-0.333333,-5,-0.333333,-5,36047019800,11228
198,2008,0,13,13,14,8,8,-0.071429,-1,0.625,5,0.625,5,36047019800,11228
198,2008,1,12,13,17,14,14,-0.294118,-5,-0.142857,-2,-0.142857,-2,36047019800,11228
198,2008,2,17,12,13,15,15,0.307692,4,0.133333,2,0.133333,2,36047019800,11228
198,2008,3,13,17,13,8,8,0,0,0.625,5,0.625,5,36047019800,11228
198,2008,4,12,13,12,14,14,0,0,-0.142857,-2,-0.142857,-2,36047019800,11228
198,2008,5,11,12,10,9,9,0.1,1,0.222222,2,0.222222,2,36047019800,11228
198,2009,0,16,16,13,16,16,0.230769,3,0,0,0,0,36047019800,11228
198,2009,1,13,16,12,10,10,0.083333,1,0.3,3,0.3,3,36047019800,11228
198,2009,2,13,13,17,15,15,-0.235294,-4,-0.133333,-2,-0.133333,-2,36047019800,11228
198,2009,3,17,13,13,12,12,0.307692,4,0.416667,5,0.416667,5,36047019800,11228
198,2009,4,17,17,12,9,9,0.416667,5,0.888889,8,0.888889,8,36047019800,11228
198,2009,5,14,17,11,15,15,0.272727,3,-0.066667,-1,-0.066667,-1,36047019800,11228
198,2010,0,12,12,16,14,14,-0.25,-4,-0.142857,-2,-0.142857,-2,36047019800,11228
198,2010,1,14,12,13,17,17,0.076923,1,-0.176471,-3,-0.176471,-3,36047019800,11228
198,2010,2,13,14,13,13,13,0,0,0,0,0,0,36047019800,11228
198,2010,3,12,13,17,13,13,-0.294118,-5,-0.076923,-1,-0.076923,-1,36047019800,11228
198,2010,4,18,12,17,12,12,0.058824,1,0.5,6,0.5,6,36047019800,11228
198,2010,5,20,18,14,10,10,0.428571,6,1,10,1,10,36047019800,11228
200,2001,0,15,15,15,15,15,0,0,0,0,0,0,36047020000,11228
200,2001,1,22,15,22,22,22,0,0,0,0,0,0,36047020000,11228
200,2001,2,13,22,13,13,13,0,0,0,0,0,0,36047020000,11228
200,2001,3,9,13,9,9,9,0,0,0,0,0,0,36047020000,11228
200,2001,4,15,9,15,15,15,0,0,0,0,0,0,36047020000,11228
200,2001,5,10,15,10,10,10,0,0,0,0,0,0,36047020000,11228
200,2002,0,7,7,15,7,7,-0.533333,-8,0,0,0,0,36047020000,11228
200,2002,1,16,7,22,16,16,-0.272727,-6,0,0,0,0,36047020000,11228
200,2002,2,19,16,13,19,19,0.461538,6,0,0,0,0,36047020000,11228
200,2002,3,13,19,9,13,13,0.444444,4,0,0,0,0,36047020000,11228
200,2002,4,11,13,15,11,11,-0.266667,-4,0,0,0,0,36047020000,11228
200,2002,5,14,11,10,14,14,0.4,4,0,0,0,0,36047020000,11228
200,2003,0,19,19,7,19,19,1.714286,12,0,0,0,0,36047020000,11228
200,2003,1,8,19,16,8,8,-0.5,-8,0,0,0,0,36047020000,11228
200,2003,2,18,8,19,18,18,-0.052632,-1,0,0,0,0,36047020000,11228
200,2003,3,18,18,13,18,18,0.384615,5,0,0,0,0,36047020000,11228
200,2003,4,16,18,11,16,16,0.454545,5,0,0,0,0,36047020000,11228
200,2003,5,11,16,14,11,11,-0.214286,-3,0,0,0,0,36047020000,11228
200,2004,0,10,10,19,15,15,-0.473684,-9,-0.333333,-5,-0.333333,-5,36047020000,11228
200,2004,1,20,10,8,22,22,1.5,12,-0.090909,-2,-0.090909,-2,36047020000,11228
200,2004,2,10,20,18,13,13,-0.444444,-8,-0.230769,-3,-0.230769,-3,36047020000,11228
200,2004,3,15,10,18,9,9,-0.166667,-3,0.666667,6,0.666667,6,36047020000,11228
200,2004,4,22,15,16,15,15,0.375,6,0.466667,7,0.466667,7,36047020000,11228
200,2004,5,20,22,11,10,10,0.818182,9,1,10,1,10,36047020000,11228
200,2005,0,17,17,10,7,7,0.7,7,1.428571,10,1.428571,10,36047020000,11228
200,2005,1,17,17,20,16,16,-0.15,-3,0.0625,1,0.0625,1,36047020000,11228
200,2005,2,19,17,10,19,19,0.9,9,0,0,0,0,36047020000,11228
200,2005,3,11,19,15,13,13,-0.266667,-4,-0.153846,-2,-0.153846,-2,36047020000,11228
200,2005,4,14,11,22,11,11,-0.363636,-8,0.272727,3,0.272727,3,36047020000,11228
200,2005,5,21,14,20,14,14,0.05,1,0.5,7,0.5,7,36047020000,11228
200,2006,0,22,22,17,19,19,0.294118,5,0.157895,3,0.157895,3,36047020000,11228
200,2006,1,17,22,17,8,8,0,0,1.125,9,1.125,9,36047020000,11228
200,2006,2,14,17,19,18,18,-0.263158,-5,-0.222222,-4,-0.222222,-4,36047020000,11228
200,2006,3,17,14,11,18,18,0.545455,6,-0.055556,-1,-0.055556,-1,36047020000,11228
200,2006,4,11,17,14,16,16,-0.214286,-3,-0.3125,-5,-0.3125,-5,36047020000,11228
200,2006,5,15,11,21,11,11,-0.285714,-6,0.363636,4,0.363636,4,36047020000,11228
200,2007,0,11,11,22,10,10,-0.5,-11,0.1,1,0.1,1,36047020000,11228
200,2007,1,24,11,17,20,20,0.411765,7,0.2,4,0.2,4,36047020000,11228
200,2007,2,18,24,14,10,10,0.285714,4,0.8,8,0.8,8,36047020000,11228
200,2007,3,15,18,17,15,15,-0.117647,-2,0,0,0,0,36047020000,11228
200,2007,4,13,15,11,22,22,0.181818,2,-0.409091,-9,-0.409091,-9,36047020000,11228
200,2007,5,14,13,15,20,20,-0.066667,-1,-0.3,-6,-0.3,-6,36047020000,11228
200,2008,0,18,18,11,17,17,0.636364,7,0.058824,1,0.058824,1,36047020000,11228
200,2008,1,15,18,24,17,17,-0.375,-9,-0.117647,-2,-0.117647,-2,36047020000,11228
200,2008,2,21,15,18,19,19,0.166667,3,0.105263,2,0.105263,2,36047020000,11228
200,2008,3,15,21,15,11,11,0,0,0.363636,4,0.363636,4,36047020000,11228
200,2008,4,15,15,13,14,14,0.153846,2,0.071429,1,0.071429,1,36047020000,11228
200,2008,5,13,15,14,21,21,-0.071429,-1,-0.380952,-8,-0.380952,-8,36047020000,11228
200,2009,0,17,17,18,22,22,-0.055556,-1,-0.227273,-5,-0.227273,-5,36047020000,11228
200,2009,1,19,17,15,17,17,0.266667,4,0.117647,2,0.117647,2,36047020000,11228
200,2009,2,20,19,21,14,14,-0.047619,-1,0.428571,6,0.428571,6,36047020000,11228
200,2009,3,23,20,15,17,17,0.533333,8,0.352941,6,0.352941,6,36047020000,11228
200,2009,4,18,23,15,11,11,0.2,3,0.636364,7,0.636364,7,36047020000,11228
200,2009,5,13,18,13,15,15,0,0,-0.133333,-2,-0.133333,-2,36047020000,11228
200,2010,0,27,27,17,11,11,0.588235,10,1.454545,16,1.454545,16,36047020000,11228
200,2010,1,19,27,19,24,24,0,0,-0.208333,-5,-0.208333,-5,36047020000,11228
200,2010,2,23,19,20,18,18,0.15,3,0.277778,5,0.277778,5,36047020000,11228
200,2010,3,22,23,23,15,15,-0.043478,-1,0.466667,7,0.466667,7,36047020000,11228
200,2010,4,23,22,18,13,13,0.277778,5,0.769231,10,0.769231,10,36047020000,11228
200,2010,5,24,23,13,14,14,0.846154,11,0.714286,10,0.714286,10,36047020000,11228
202,2001,0,9,9,9,9,9,0,0,0,0,0,0,36047020200,11228
202,2001,1,7,9,7,7,7,0,0,0,0,0,0,36047020200,11228
202,2001,2,7,7,7,7,7,0,0,0,0,0,0,36047020200,11228
202,2001,3,10,7,10,10,10,0,0,0,0,0,0,36047020200,11228
202,2001,4,7,10,7,7,7,0,0,0,0,0,0,36047020200,11228
202,2001,5,5,7,5,5,5,0,0,0,0,0,0,36047020200,11228
202,2002,0,8,8,9,8,8,-0.111111,-1,0,0,0,0,36047020200,11228
202,2002,1,10,8,7,10,10,0.428571,3,0,0,0,0,36047020200,11228
202,2002,2,8,10,7,8,8,0.142857,1,0,0,0,0,36047020200,11228
202,2002,3,5,8,10,5,5,-0.5,-5,0,0,0,0,36047020200,11228
202,2002,4,10,5,7,10,10,0.428571,3,0,0,0,0,36047020200,11228
202,2002,5,8,10,5,8,8,0.6,3,0,0,0,0,36047020200,11228
202,2003,0,5,5,8,5,5,-0.375,-3,0,0,0,0,36047020200,11228
202,2003,1,8,5,10,8,8,-0.2,-2,0,0,0,0,36047020200,11228
202,2003,2,8,8,8,8,8,0,0,0,0,0,0,36047020200,11228
202,2003,3,7,8,5,7,7,0.4,2,0,0,0,0,36047020200,11228
202,2003,4,8,7,10,8,8,-0.2,-2,0,0,0,0,36047020200,11228
202,2003,5,11,8,8,11,11,0.375,3,0,0,0,0,36047020200,11228
202,2004,0,8,8,5,9,9,0.6,3,-0.111111,-1,-0.111111,-1,36047020200,11228
202,2004,1,9,8,8,7,7,0.125,1,0.285714,2,0.285714,2,36047020200,11228
202,2004,2,9,9,8,7,7,0.125,1,0.285714,2,0.285714,2,36047020200,11228
202,2004,3,7,9,7,10,10,0,0,-0.3,-3,-0.3,-3,36047020200,11228
202,2004,4,7,7,8,7,7,-0.125,-1,0,0,0,0,36047020200,11228
202,2004,5,11,7,11,5,5,0,0,1.2,6,1.2,6,36047020200,11228
202,2005,0,12,12,8,8,8,0.5,4,0.5,4,0.5,4,36047020200,11228
202,2005,1,7,12,9,10,10,-0.222222,-2,-0.3,-3,-0.3,-3,36047020200,11228
202,2005,2,11,7,9,8,8,0.222222,2,0.375,3,0.375,3,36047020200,11228
202,2005,3,11,11,7,5,5,0.571429,4,1.2,6,1.2,6,36047020200,11228
202,2005,4,8,11,7,10,10,0.142857,1,-0.2,-2,-0.2,-2,36047020200,11228
202,2005,5,8,8,11,8,8,-0.272727,-3,0,0,0,0,36047020200,11228
202,2006,0,2,2,12,5,5,-0.833333,-10,-0.6,-3,-0.6,-3,36047020200,11228
202,2006,1,18,2,7,8,8,1.571429,11,1.25,10,1.25,10,36047020200,11228
202,2006,2,6,18,11,8,8,-0.454545,-5,-0.25,-2,-0.25,-2,36047020200,11228
202,2006,3,10,6,11,7,7,-0.090909,-1,0.428571,3,0.428571,3,36047020200,11228
202,2006,4,10,10,8,8,8,0.25,2,0.25,2,0.25,2,36047020200,11228
202,2006,5,7,10,8,11,11,-0.125,-1,-0.363636,-4,-0.363636,-4,36047020200,11228
202,2007,0,4,4,2,8,8,1,2,-0.5,-4,-0.5,-4,36047020200,11228
202,2007,1,2,4,18,9,9,-0.888889,-16,-0.777778,-7,-0.777778,-7,36047020200,11228
202,2007,2,16,2,6,9,9,1.666667,10,0.777778,7,0.777778,7,36047020200,11228
202,2007,3,7,16,10,7,7,-0.3,-3,0,0,0,0,36047020200,11228
202,2007,4,11,7,10,7,7,0.1,1,0.571429,4,0.571429,4,36047020200,11228
202,2007,5,9,11,7,11,11,0.285714,2,-0.181818,-2,-0.181818,-2,36047020200,11228
202,2008,0,10,10,4,12,12,1.5,6,-0.166667,-2,-0.166667,-2,36047020200,11228
202,2008,1,11,10,2,7,7,4.5,9,0.571429,4,0.571429,4,36047020200,11228
202,2008,2,2,11,16,11,11,-0.875,-14,-0.818182,-9,-0.818182,-9,36047020200,11228
202,2008,3,17,2,7,11,11,1.428571,10,0.545455,6,0.545455,6,36047020200,11228
202,2008,4,6,17,11,8,8,-0.454545,-5,-0.25,-2,-0.25,-2,36047020200,11228
202,2008,5,16,6,9,8,8,0.777778,7,1,8,1,8,36047020200,11228
202,2009,0,11,11,10,2,2,0.1,1,4.5,9,4.5,9,36047020200,11228
202,2009,1,15,11,11,18,18,0.363636,4,-0.166667,-3,-0.166667,-3,36047020200,11228
202,2009,2,12,15,2,6,6,5,10,1,6,1,6,36047020200,11228
202,2009,3,6,12,17,10,10,-0.647059,-11,-0.4,-4,-0.4,-4,36047020200,11228
202,2009,4,20,6,6,10,10,2.333333,14,1,10,1,10,36047020200,11228
202,2009,5,12,20,16,7,7,-0.25,-4,0.714286,5,0.714286,5,36047020200,11228
202,2010,0,12,12,11,4,4,0.090909,1,2,8,2,8,36047020200,11228
202,2010,1,15,12,15,2,2,0,0,6.5,13,6.5,13,36047020200,11228
202,2010,2,14,15,12,16,16,0.166667,2,-0.125,-2,-0.125,-2,36047020200,11228
202,2010,3,14,14,6,7,7,1.333333,8,1,7,1,7,36047020200,11228
202,2010,4,7,14,20,11,11,-0.65,-13,-0.363636,-4,-0.363636,-4,36047020200,11228
202,2010,5,21,7,12,9,9,0.75,9,1.333333,12,1.333333,12,36047020200,11228
204,2001,0,8,8,8,8,8,0,0,0,0,0,0,36047020400,11228
204,2001,1,7,8,7,7,7,0,0,0,0,0,0,36047020400,11228
204,2001,2,6,7,6,6,6,0,0,0,0,0,0,36047020400,11228
204,2001,3,5,6,5,5,5,0,0,0,0,0,0,36047020400,11228
204,2001,4,5,5,5,5,5,0,0,0,0,0,0,36047020400,11228
204,2001,5,5,5,5,5,5,0,0,0,0,0,0,36047020400,11228
204,2002,0,11,11,8,11,11,0.375,3,0,0,0,0,36047020400,11228
204,2002,1,10,11,7,10,10,0.428571,3,0,0,0,0,36047020400,11228
204,2002,2,6,10,6,6,6,0,0,0,0,0,0,36047020400,11228
204,2002,3,5,6,5,5,5,0,0,0,0,0,0,36047020400,11228
204,2002,4,7,5,5,7,7,0.4,2,0,0,0,0,36047020400,11228
204,2002,5,6,7,5,6,6,0.2,1,0,0,0,0,36047020400,11228
204,2003,0,2,2,11,2,2,-0.818182,-9,0,0,0,0,36047020400,11228
204,2003,1,13,2,10,13,13,0.3,3,0,0,0,0,36047020400,11228
204,2003,2,9,13,6,9,9,0.5,3,0,0,0,0,36047020400,11228
204,2003,3,7,9,5,7,7,0.4,2,0,0,0,0,36047020400,11228
204,2003,4,6,7,7,6,6,-0.142857,-1,0,0,0,0,36047020400,11228
204,2003,5,8,6,6,8,8,0.333333,2,0,0,0,0,36047020400,11228
204,2004,0,6,6,2,8,8,2,4,-0.25,-2,-0.25,-2,36047020400,11228
204,2004,1,4,6,13,7,7,-0.692308,-9,-0.428571,-3,-0.428571,-3,36047020400,11228
204,2004,2,11,4,9,6,6,0.222222,2,0.833333,5,0.833333,5,36047020400,11228
204,2004,3,11,11,7,5,5,0.571429,4,1.2,6,1.2,6,36047020400,11228
204,2004,4,6,11,6,5,5,0,0,0.2,1,0.2,1,36047020400,11228
204,2004,5,8,6,8,5,5,0,0,0.6,3,0.6,3,36047020400,11228
204,2005,0,6,6,6,11,11,0,0,-0.454545,-5,-0.454545,-5,36047020400,11228
204,2005,1,7,6,4,10,10,0.75,3,-0.3,-3,-0.3,-3,36047020400,11228
204,2005,2,4,7,11,6,6,-0.636364,-7,-0.333333,-2,-0.333333,-2,36047020400,11228
204,2005,3,9,4,11,5,5,-0.181818,-2,0.8,4,0.8,4,36047020400,11228
204,2005,4,11,9,6,7,7,0.833333,5,0.571429,4,0.571429,4,36047020400,11228
204,2005,5,7,11,8,6,6,-0.125,-1,0.166667,1,0.166667,1,36047020400,11228
204,2006,0,4,4,6,2,2,-0.333333,-2,1,2,1,2,36047020400,11228
204,2006,1,11,4,7,13,13,0.571429,4,-0.153846,-2,-0.153846,-2,36047020400,11228
204,2006,2,5,11,4,9,9,0.25,1,-0.444444,-4,-0.444444,-4,36047020400,11228
204,2006,3,4,5,9,7,7,-0.555556,-5,-0.428571,-3,-0.428571,-3,36047020400,11228
204,2006,4,10,4,11,6,6,-0.090909,-1,0.666667,4,0.666667,4,36047020400,11228
204,2006,5,10,10,7,8,8,0.428571,3,0.25,2,0.25,2,36047020400,11228
204,2007,0,7,7,4,6,6,0.75,3,0.166667,1,0.166667,1,36047020400,11228
204,2007,1,2,7,11,4,4,-0.818182,-9,-0.5,-2,-0.5,-2,36047020400,11228
204,2007,2,12,2,5,11,11,1.4,7,0.090909,1,0.090909,1,36047020400,11228
204,2007,3,3,12,4,11,11,-0.25,-1,-0.727273,-8,-0.727273,-8,36047020400,11228
204,2007,4,2,3,10,6,6,-0.8,-8,-0.666667,-4,-0.666667,-4,36047020400,11228
204,2007,5,10,2,10,8,8,0,0,0.25,2,0.25,2,36047020400,11228
204,2008,0,5,5,7,6,6,-0.285714,-2,-0.166667,-1,-0.166667,-1,36047020400,11228
204,2008,1,7,5,2,7,7,2.5,5,0,0,0,0,36047020400,11228
204,2008,2,4,7,12,4,4,-0.666667,-8,0,0,0,0,36047020400,11228
204,2008,3,12,4,3,9,9,3,9,0.333333,3,0.333333,3,36047020400,11228
204,2008,4,5,12,2,11,11,1.5,3,-0.545455,-6,-0.545455,-6,36047020400,11228
204,2008,5,3,5,10,7,7,-0.7,-7,-0.571429,-4,-0.571429,-4,36047020400,11228
204,2009,0,8,8,5,4,4,0.6,3,1,4,1,4,36047020400,11228
204,2009,1,4,8,7,11,11,-0.428571,-3,-0.636364,-7,-0.636364,-7,36047020400,11228
204,2009,2,12,4,4,5,5,2,8,1.4,7,1.4,7,36047020400,11228
204,2009,3,5,12,12,4,4,-0.583333,-7,0.25,1,0.25,1,36047020400,11228
204,2009,4,12,5,5,10,10,1.4,7,0.2,2,0.2,2,36047020400,11228
204,2009,5,11,12,3,10,10,2.666667,8,0.1,1,0.1,1,36047020400,11228
204,2010,0,11,11,8,7,7,0.375,3,0.571429,4,0.571429,4,36047020400,11228
204,2010,1,9,11,4,2,2,1.25,5,3.5,7,3.5,7,36047020400,11228
204,2010,2,6,9,12,12,12,-0.5,-6,-0.5,-6,-0.5,-6,36047020400,11228
204,2010,3,13,6,5,3,3,1.6,8,3.333333,10,3.333333,10,36047020400,11228
204,2010,4,5,13,12,2,2,-0.583333,-7,1.5,3,1.5,3,36047020400,11228
204,2010,5,16,5,11,10,10,0.454545,5,0.6,6,0.6,6,36047020400,11228
206,2001,0,14,14,14,14,14,0,0,0,0,0,0,36047020600,11228
206,2001,1,11,14,11,11,11,0,0,0,0,0,0,36047020600,11228
206,2001,2,15,11,15,15,15,0,0,0,0,0,0,36047020600,11228
206,2001,3,14,15,14,14,14,0,0,0,0,0,0,36047020600,11228
206,2001,4,13,14,13,13,13,0,0,0,0,0,0,36047020600,11228
206,2001,5,12,13,12,12,12,0,0,0,0,0,0,36047020600,11228
206,2002,0,9,9,14,9,9,-0.357143,-5,0,0,0,0,36047020600,11228
206,2002,1,19,9,11,19,19,0.727273,8,0,0,0,0,36047020600,11228
206,2002,2,14,19,15,14,14,-0.066667,-1,0,0,0,0,36047020600,11228
206,2002,3,14,14,14,14,14,0,0,0,0,0,0,36047020600,11228
206,2002,4,15,14,13,15,15,0.153846,2,0,0,0,0,36047020600,11228
206,2002,5,19,15,12,19,19,0.583333,7,0,0,0,0,36047020600,11228
206,2003,0,15,15,9,15,15,0.666667,6,0,0,0,0,36047020600,11228
206,2003,1,10,15,19,10,10,-0.473684,-9,0,0,0,0,36047020600,11228
206,2003,2,19,10,14,19,19,0.357143,5,0,0,0,0,36047020600,11228
206,2003,3,16,19,14,16,16,0.142857,2,0,0,0,0,36047020600,11228
206,2003,4,16,16,15,16,16,0.066667,1,0,0,0,0,36047020600,11228
206,2003,5,17,16,19,17,17,-0.105263,-2,0,0,0,0,36047020600,11228
206,2004,0,13,13,15,14,14,-0.133333,-2,-0.071429,-1,-0.071429,-1,36047020600,11228
206,2004,1,14,13,10,11,11,0.4,4,0.272727,3,0.272727,3,36047020600,11228
206,2004,2,12,14,19,15,15,-0.368421,-7,-0.2,-3,-0.2,-3,36047020600,11228
206,2004,3,14,12,16,14,14,-0.125,-2,0,0,0,0,36047020600,11228
206,2004,4,18,14,16,13,13,0.125,2,0.384615,5,0.384615,5,36047020600,11228
206,2004,5,12,18,17,12,12,-0.294118,-5,0,0,0,0,36047020600,11228
206,2005,0,11,11,13,9,9,-0.153846,-2,0.222222,2,0.222222,2,36047020600,11228
206,2005,1,12,11,14,19,19,-0.142857,-2,-0.368421,-7,-0.368421,-7,36047020600,11228
206,2005,2,16,12,12,14,14,0.333333,4,0.142857,2,0.142857,2,36047020600,11228
206,2005,3,13,16,14,14,14,-0.071429,-1,-0.071429,-1,-0.071429,-1,36047020600,11228
206,2005,4,14,13,18,15,15,-0.222222,-4,-0.066667,-1,-0.066667,-1,36047020600,11228
206,2005,5,18,14,12,19,19,0.5,6,-0.052632,-1,-0.052632,-1,36047020600,11228
206,2006,0,15,15,11,15,15,0.363636,4,0,0,0,0,36047020600,11228
206,2006,1,13,15,12,10,10,0.083333,1,0.3,3,0.3,3,36047020600,11228
206,2006,2,12,13,16,19,19,-0.25,-4,-0.368421,-7,-0.368421,-7,36047020600,11228
206,2006,3,11,12,13,16,16,-0.153846,-2,-0.3125,-5,-0.3125,-5,36047020600,11228
206,2006,4,15,11,14,16,16,0.071429,1,-0.0625,-1,-0.0625,-1,36047020600,11228
206,2006,5,12,15,18,17,17,-0.333333,-6,-0.294118,-5,-0.294118,-5,36047020600,11228
206,2007,0,8,8,15,13,13,-0.466667,-7,-0.384615,-5,-0.384615,-5,36047020600,11228
206,2007,1,17,8,13,14,14,0.307692,4,0.214286,3,0.214286,3,36047020600,11228
206,2007,2,12,17,12,12,12,0,0,0,0,0,0,36047020600,11228
206,2007,3,10,12,11,14,14,-0.090909,-1,-0.285714,-4,-0.285714,-4,36047020600,11228
206,2007,4,13,10,15,18,18,-0.133333,-2,-0.277778,-5,-0.277778,-5,36047020600,11228
206,2007,5,15,13,12,12,12,0.25,3,0.25,3,0.25,3,36047020600,11228
206,2008,0,13,13,8,11,11,0.625,5,0.181818,2,0.181818,2,36047020600,11228
206,2008,1,10,13,17,12,12,-0.411765,-7,-0.166667,-2,-0.166667,-2,36047020600,11228
206,2008,2,16,10,12,16,16,0.333333,4,0,0,0,0,36047020600,11228
206,2008,3,12,16,10,13,13,0.2,2,-0.076923,-1,-0.076923,-1,36047020600,11228
206,2008,4,11,12,13,14,14,-0.153846,-2,-0.214286,-3,-0.214286,-3,36047020600,11228
206,2008,5,15,11,15,18,18,0,0,-0.166667,-3,-0.166667,-3,36047020600,11228
206,2009,0,15,15,13,15,15,0.153846,2,0,0,0,0,36047020600,11228
206,2009,1,13,15,10,13,13,0.3,3,0,0,0,0,36047020600,11228
206,2009,2,12,13,16,12,12,-0.25,-4,0,0,0,0,36047020600,11228
206,2009,3,16,12,12,11,11,0.333333,4,0.454545,5,0.454545,5,36047020600,11228
206,2009,4,18,16,11,15,15,0.636364,7,0.2,3,0.2,3,36047020600,11228
206,2009,5,12,18,15,12,12,-0.2,-3,0,0,0,0,36047020600,11228
206,2010,0,19,19,15,8,8,0.266667,4,1.375,11,1.375,11,36047020600,11228
206,2010,1,18,19,13,17,17,0.384615,5,0.058824,1,0.058824,1,36047020600,11228
206,2010,2,13,18,12,12,12,0.083333,1,0.083333,1,0.083333,1,36047020600,11228
206,2010,3,13,13,16,10,10,-0.1875,-3,0.3,3,0.3,3,36047020600,11228
206,2010,4,16,13,18,13,13,-0.111111,-2,0.230769,3,0.230769,3,36047020600,11228
206,2010,5,16,16,12,15,15,0.333333,4,0.066667,1,0.066667,1,36047020600,11228
207,2010,3,1,0,0,0,0,1,1,1,1,1,1,36047020700,11238
208,2001,0,13,13,13,13,13,0,0,0,0,0,0,36047020800,11219
208,2001,1,20,13,20,20,20,0,0,0,0,0,0,36047020800,11219
208,2001,2,20,20,20,20,20,0,0,0,0,0,0,36047020800,11219
208,2001,3,19,20,19,19,19,0,0,0,0,0,0,36047020800,11219
208,2001,4,23,19,23,23,23,0,0,0,0,0,0,36047020800,11219
208,2001,5,19,23,19,19,19,0,0,0,0,0,0,36047020800,11219
208,2002,0,19,19,13,19,19,0.461538,6,0,0,0,0,36047020800,11219
208,2002,1,17,19,20,17,17,-0.15,-3,0,0,0,0,36047020800,11219
208,2002,2,23,17,20,23,23,0.15,3,0,0,0,0,36047020800,11219
208,2002,3,22,23,19,22,22,0.157895,3,0,0,0,0,36047020800,11219
208,2002,4,18,22,23,18,18,-0.217391,-5,0,0,0,0,36047020800,11219
208,2002,5,30,18,19,30,30,0.578947,11,0,0,0,0,36047020800,11219
208,2003,0,12,12,19,12,12,-0.368421,-7,0,0,0,0,36047020800,11219
208,2003,1,18,12,17,18,18,0.058824,1,0,0,0,0,36047020800,11219
208,2003,2,15,18,23,15,15,-0.347826,-8,0,0,0,0,36047020800,11219
208,2003,3,23,15,22,23,23,0.045455,1,0,0,0,0,36047020800,11219
208,2003,4,24,23,18,24,24,0.333333,6,0,0,0,0,36047020800,11219
208,2003,5,21,24,30,21,21,-0.3,-9,0,0,0,0,36047020800,11219
208,2004,0,14,14,12,13,13,0.166667,2,0.076923,1,0.076923,1,36047020800,11219
208,2004,1,12,14,18,20,20,-0.333333,-6,-0.4,-8,-0.4,-8,36047020800,11219
208,2004,2,13,12,15,20,20,-0.133333,-2,-0.35,-7,-0.35,-7,36047020800,11219
208,2004,3,17,13,23,19,19,-0.26087,-6,-0.105263,-2,-0.105263,-2,36047020800,11219
208,2004,4,21,17,24,23,23,-0.125,-3,-0.086957,-2,-0.086957,-2,36047020800,11219
208,2004,5,24,21,21,19,19,0.142857,3,0.263158,5,0.263158,5,36047020800,11219
208,2005,0,17,17,14,19,19,0.214286,3,-0.105263,-2,-0.105263,-2,36047020800,11219
208,2005,1,15,17,12,17,17,0.25,3,-0.117647,-2,-0.117647,-2,36047020800,11219
208,2005,2,14,15,13,23,23,0.076923,1,-0.391304,-9,-0.391304,-9,36047020800,11219
208,2005,3,15,14,17,22,22,-0.117647,-2,-0.318182,-7,-0.318182,-7,36047020800,11219
208,2005,4,18,15,21,18,18,-0.142857,-3,0,0,0,0,36047020800,11219
208,2005,5,23,18,24,30,30,-0.041667,-1,-0.233333,-7,-0.233333,-7,36047020800,11219
208,2006,0,18,18,17,12,12,0.058824,1,0.5,6,0.5,6,36047020800,11219
208,2006,1,19,18,15,18,18,0.266667,4,0.055556,1,0.055556,1,36047020800,11219
208,2006,2,17,19,14,15,15,0.214286,3,0.133333,2,0.133333,2,36047020800,11219
208,2006,3,10,17,15,23,23,-0.333333,-5,-0.565217,-13,-0.565217,-13,36047020800,11219
208,2006,4,14,10,18,24,24,-0.222222,-4,-0.416667,-10,-0.416667,-10,36047020800,11219
208,2006,5,21,14,23,21,21,-0.086957,-2,0,0,0,0,36047020800,11219
208,2007,0,12,12,18,14,14,-0.333333,-6,-0.142857,-2,-0.142857,-2,36047020800,11219
208,2007,1,18,12,19,12,12,-0.052632,-1,0.5,6,0.5,6,36047020800,11219
208,2007,2,22,18,17,13,13,0.294118,5,0.692308,9,0.692308,9,36047020800,11219
208,2007,3,16,22,10,17,17,0.6,6,-0.058824,-1,-0.058824,-1,36047020800,11219
208,2007,4,13,16,14,21,21,-0.071429,-1,-0.380952,-8,-0.380952,-8,36047020800,11219
208,2007,5,14,13,21,24,24,-0.333333,-7,-0.416667,-10,-0.416667,-10,36047020800,11219
208,2008,0,18,18,12,17,17,0.5,6,0.058824,1,0.058824,1,36047020800,11219
208,2008,1,19,18,18,15,15,0.055556,1,0.266667,4,0.266667,4,36047020800,11219
208,2008,2,21,19,22,14,14,-0.045455,-1,0.5,7,0.5,7,36047020800,11219
208,2008,3,26,21,16,15,15,0.625,10,0.733333,11,0.733333,11,36047020800,11219
208,2008,4,21,26,13,18,18,0.615385,8,0.166667,3,0.166667,3,36047020800,11219
208,2008,5,18,21,14,23,23,0.285714,4,-0.217391,-5,-0.217391,-5,36047020800,11219
208,2009,0,27,27,18,18,18,0.5,9,0.5,9,0.5,9,36047020800,11219
208,2009,1,23,27,19,19,19,0.210526,4,0.210526,4,0.210526,4,36047020800,11219
208,2009,2,23,23,21,17,17,0.095238,2,0.352941,6,0.352941,6,36047020800,11219
208,2009,3,25,23,26,10,10,-0.038462,-1,1.5,15,1.5,15,36047020800,11219
208,2009,4,29,25,21,14,14,0.380952,8,1.071429,15,1.071429,15,36047020800,11219
208,2009,5,31,29,18,21,21,0.722222,13,0.47619,10,0.47619,10,36047020800,11219
208,2010,0,19,19,27,12,12,-0.296296,-8,0.583333,7,0.583333,7,36047020800,11219
208,2010,1,32,19,23,18,18,0.391304,9,0.777778,14,0.777778,14,36047020800,11219
208,2010,2,26,32,23,22,22,0.130435,3,0.181818,4,0.181818,4,36047020800,11219
208,2010,3,28,26,25,16,16,0.12,3,0.75,12,0.75,12,36047020800,11219
208,2010,4,28,28,29,13,13,-0.034483,-1,1.153846,15,1.153846,15,36047020800,11219
208,2010,5,38,28,31,14,14,0.225806,7,1.714286,24,1.714286,24,36047020800,11219
210,2001,0,27,27,27,27,27,0,0,0,0,0,0,36047021000,11219
210,2001,1,17,27,17,17,17,0,0,0,0,0,0,36047021000,11219
210,2001,2,39,17,39,39,39,0,0,0,0,0,0,36047021000,11219
210,2001,3,19,39,19,19,19,0,0,0,0,0,0,36047021000,11219
210,2001,4,23,19,23,23,23,0,0,0,0,0,0,36047021000,11219
210,2001,5,29,23,29,29,29,0,0,0,0,0,0,36047021000,11219
210,2002,0,27,27,27,27,27,0,0,0,0,0,0,36047021000,11219
210,2002,1,24,27,17,24,24,0.411765,7,0,0,0,0,36047021000,11219
210,2002,2,20,24,39,20,20,-0.487179,-19,0,0,0,0,36047021000,11219
210,2002,3,40,20,19,40,40,1.105263,21,0,0,0,0,36047021000,11219
210,2002,4,19,40,23,19,19,-0.173913,-4,0,0,0,0,36047021000,11219
210,2002,5,27,19,29,27,27,-0.068966,-2,0,0,0,0,36047021000,11219
210,2003,0,26,26,27,26,26,-0.037037,-1,0,0,0,0,36047021000,11219
210,2003,1,30,26,24,30,30,0.25,6,0,0,0,0,36047021000,11219
210,2003,2,27,30,20,27,27,0.35,7,0,0,0,0,36047021000,11219
210,2003,3,27,27,40,27,27,-0.325,-13,0,0,0,0,36047021000,11219
210,2003,4,45,27,19,45,45,1.368421,26,0,0,0,0,36047021000,11219
210,2003,5,22,45,27,22,22,-0.185185,-5,0,0,0,0,36047021000,11219
210,2004,0,22,22,26,27,27,-0.153846,-4,-0.185185,-5,-0.185185,-5,36047021000,11219
210,2004,1,28,22,30,17,17,-0.066667,-2,0.647059,11,0.647059,11,36047021000,11219
210,2004,2,32,28,27,39,39,0.185185,5,-0.179487,-7,-0.179487,-7,36047021000,11219
210,2004,3,27,32,27,19,19,0,0,0.421053,8,0.421053,8,36047021000,11219
210,2004,4,26,27,45,23,23,-0.422222,-19,0.130435,3,0.130435,3,36047021000,11219
210,2004,5,44,26,22,29,29,1,22,0.517241,15,0.517241,15,36047021000,11219
210,2005,0,23,23,22,27,27,0.045455,1,-0.148148,-4,-0.148148,-4,36047021000,11219
210,2005,1,28,23,28,24,24,0,0,0.166667,4,0.166667,4,36047021000,11219
210,2005,2,32,28,32,20,20,0,0,0.6,12,0.6,12,36047021000,11219
210,2005,3,35,32,27,40,40,0.296296,8,-0.125,-5,-0.125,-5,36047021000,11219
210,2005,4,27,35,26,19,19,0.038462,1,0.421053,8,0.421053,8,36047021000,11219
210,2005,5,29,27,44,27,27,-0.340909,-15,0.074074,2,0.074074,2,36047021000,11219
210,2006,0,16,16,23,26,26,-0.304348,-7,-0.384615,-10,-0.384615,-10,36047021000,11219
210,2006,1,27,16,28,30,30,-0.035714,-1,-0.1,-3,-0.1,-3,36047021000,11219
210,2006,2,30,27,32,27,27,-0.0625,-2,0.111111,3,0.111111,3,36047021000,11219
210,2006,3,35,30,35,27,27,0,0,0.296296,8,0.296296,8,36047021000,11219
210,2006,4,30,35,27,45,45,0.111111,3,-0.333333,-15,-0.333333,-15,36047021000,11219
210,2006,5,28,30,29,22,22,-0.034483,-1,0.272727,6,0.272727,6,36047021000,11219
210,2007,0,20,20,16,22,22,0.25,4,-0.090909,-2,-0.090909,-2,36047021000,11219
210,2007,1,13,20,27,28,28,-0.518519,-14,-0.535714,-15,-0.535714,-15,36047021000,11219
210,2007,2,25,13,30,32,32,-0.166667,-5,-0.21875,-7,-0.21875,-7,36047021000,11219
210,2007,3,27,25,35,27,27,-0.228571,-8,0,0,0,0,36047021000,11219
210,2007,4,32,27,30,26,26,0.066667,2,0.230769,6,0.230769,6,36047021000,11219
210,2007,5,30,32,28,44,44,0.071429,2,-0.318182,-14,-0.318182,-14,36047021000,11219
210,2008,0,36,36,20,23,23,0.8,16,0.565217,13,0.565217,13,36047021000,11219
210,2008,1,22,36,13,28,28,0.692308,9,-0.214286,-6,-0.214286,-6,36047021000,11219
210,2008,2,23,22,25,32,32,-0.08,-2,-0.28125,-9,-0.28125,-9,36047021000,11219
210,2008,3,26,23,27,35,35,-0.037037,-1,-0.257143,-9,-0.257143,-9,36047021000,11219
210,2008,4,29,26,32,27,27,-0.09375,-3,0.074074,2,0.074074,2,36047021000,11219
210,2008,5,30,29,30,29,29,0,0,0.034483,1,0.034483,1,36047021000,11219
210,2009,0,48,48,36,16,16,0.333333,12,2,32,2,32,36047021000,11219
210,2009,1,45,48,22,27,27,1.045455,23,0.666667,18,0.666667,18,36047021000,11219
210,2009,2,30,45,23,30,30,0.304348,7,0,0,0,0,36047021000,11219
210,2009,3,31,30,26,35,35,0.192308,5,-0.114286,-4,-0.114286,-4,36047021000,11219
210,2009,4,30,31,29,30,30,0.034483,1,0,0,0,0,36047021000,11219
210,2009,5,35,30,30,28,28,0.166667,5,0.25,7,0.25,7,36047021000,11219
210,2010,0,45,45,48,20,20,-0.0625,-3,1.25,25,1.25,25,36047021000,11219
210,2010,1,57,45,45,13,13,0.266667,12,3.384615,44,3.384615,44,36047021000,11219
210,2010,2,46,57,30,25,25,0.533333,16,0.84,21,0.84,21,36047021000,11219
210,2010,3,29,46,31,27,27,-0.064516,-2,0.074074,2,0.074074,2,36047021000,11219
210,2010,4,33,29,30,32,32,0.1,3,0.03125,1,0.03125,1,36047021000,11219
210,2010,5,33,33,35,30,30,-0.057143,-2,0.1,3,0.1,3,36047021000,11219
212,2001,0,27,27,27,27,27,0,0,0,0,0,0,36047021200,11219
212,2001,1,38,27,38,38,38,0,0,0,0,0,0,36047021200,11219
212,2001,2,50,38,50,50,50,0,0,0,0,0,0,36047021200,11219
212,2001,3,33,50,33,33,33,0,0,0,0,0,0,36047021200,11219
212,2001,4,31,33,31,31,31,0,0,0,0,0,0,36047021200,11219
212,2001,5,42,31,42,42,42,0,0,0,0,0,0,36047021200,11219
212,2002,0,41,41,27,41,41,0.518519,14,0,0,0,0,36047021200,11219
212,2002,1,27,41,38,27,27,-0.289474,-11,0,0,0,0,36047021200,11219
212,2002,2,36,27,50,36,36,-0.28,-14,0,0,0,0,36047021200,11219
212,2002,3,46,36,33,46,46,0.393939,13,0,0,0,0,36047021200,11219
212,2002,4,32,46,31,32,32,0.032258,1,0,0,0,0,36047021200,11219
212,2002,5,35,32,42,35,35,-0.166667,-7,0,0,0,0,36047021200,11219
212,2003,0,33,33,41,33,33,-0.195122,-8,0,0,0,0,36047021200,11219
212,2003,1,39,33,27,39,39,0.444444,12,0,0,0,0,36047021200,11219
212,2003,2,26,39,36,26,26,-0.277778,-10,0,0,0,0,36047021200,11219
212,2003,3,38,26,46,38,38,-0.173913,-8,0,0,0,0,36047021200,11219
212,2003,4,47,38,32,47,47,0.46875,15,0,0,0,0,36047021200,11219
212,2003,5,34,47,35,34,34,-0.028571,-1,0,0,0,0,36047021200,11219
212,2004,0,49,49,33,27,27,0.484848,16,0.814815,22,0.814815,22,36047021200,11219
212,2004,1,37,49,39,38,38,-0.051282,-2,-0.026316,-1,-0.026316,-1,36047021200,11219
212,2004,2,36,37,26,50,50,0.384615,10,-0.28,-14,-0.28,-14,36047021200,11219
212,2004,3,26,36,38,33,33,-0.315789,-12,-0.212121,-7,-0.212121,-7,36047021200,11219
212,2004,4,34,26,47,31,31,-0.276596,-13,0.096774,3,0.096774,3,36047021200,11219
212,2004,5,46,34,34,42,42,0.352941,12,0.095238,4,0.095238,4,36047021200,11219
212,2005,0,52,52,49,41,41,0.061224,3,0.268293,11,0.268293,11,36047021200,11219
212,2005,1,45,52,37,27,27,0.216216,8,0.666667,18,0.666667,18,36047021200,11219
212,2005,2,36,45,36,36,36,0,0,0,0,0,0,36047021200,11219
212,2005,3,30,36,26,46,46,0.153846,4,-0.347826,-16,-0.347826,-16,36047021200,11219
212,2005,4,26,30,34,32,32,-0.235294,-8,-0.1875,-6,-0.1875,-6,36047021200,11219
212,2005,5,45,26,46,35,35,-0.021739,-1,0.285714,10,0.285714,10,36047021200,11219
212,2006,0,48,48,52,33,33,-0.076923,-4,0.454545,15,0.454545,15,36047021200,11219
212,2006,1,51,48,45,39,39,0.133333,6,0.307692,12,0.307692,12,36047021200,11219
212,2006,2,51,51,36,26,26,0.416667,15,0.961538,25,0.961538,25,36047021200,11219
212,2006,3,35,51,30,38,38,0.166667,5,-0.078947,-3,-0.078947,-3,36047021200,11219
212,2006,4,32,35,26,47,47,0.230769,6,-0.319149,-15,-0.319149,-15,36047021200,11219
212,2006,5,31,32,45,34,34,-0.311111,-14,-0.088235,-3,-0.088235,-3,36047021200,11219
212,2007,0,39,39,48,49,49,-0.1875,-9,-0.204082,-10,-0.204082,-10,36047021200,11219
212,2007,1,55,39,51,37,37,0.078431,4,0.486486,18,0.486486,18,36047021200,11219
212,2007,2,55,55,51,36,36,0.078431,4,0.527778,19,0.527778,19,36047021200,11219
212,2007,3,51,55,35,26,26,0.457143,16,0.961538,25,0.961538,25,36047021200,11219
212,2007,4,34,51,32,34,34,0.0625,2,0,0,0,0,36047021200,11219
212,2007,5,27,34,31,46,46,-0.129032,-4,-0.413043,-19,-0.413043,-19,36047021200,11219
212,2008,0,44,44,39,52,52,0.128205,5,-0.153846,-8,-0.153846,-8,36047021200,11219
212,2008,1,46,44,55,45,45,-0.163636,-9,0.022222,1,0.022222,1,36047021200,11219
212,2008,2,54,46,55,36,36,-0.018182,-1,0.5,18,0.5,18,36047021200,11219
212,2008,3,59,54,51,30,30,0.156863,8,0.966667,29,0.966667,29,36047021200,11219
212,2008,4,53,59,34,26,26,0.558824,19,1.038462,27,1.038462,27,36047021200,11219
212,2008,5,32,53,27,45,45,0.185185,5,-0.288889,-13,-0.288889,-13,36047021200,11219
212,2009,0,46,46,44,48,48,0.045455,2,-0.041667,-2,-0.041667,-2,36047021200,11219
212,2009,1,56,46,46,51,51,0.217391,10,0.098039,5,0.098039,5,36047021200,11219
212,2009,2,52,56,54,51,51,-0.037037,-2,0.019608,1,0.019608,1,36047021200,11219
212,2009,3,55,52,59,35,35,-0.067797,-4,0.571429,20,0.571429,20,36047021200,11219
212,2009,4,59,55,53,32,32,0.113208,6,0.84375,27,0.84375,27,36047021200,11219
212,2009,5,61,59,32,31,31,0.90625,29,0.967742,30,0.967742,30,36047021200,11219
212,2010,0,51,51,46,39,39,0.108696,5,0.307692,12,0.307692,12,36047021200,11219
212,2010,1,51,51,56,55,55,-0.089286,-5,-0.072727,-4,-0.072727,-4,36047021200,11219
212,2010,2,56,51,52,55,55,0.076923,4,0.018182,1,0.018182,1,36047021200,11219
212,2010,3,41,56,55,51,51,-0.254545,-14,-0.196078,-10,-0.196078,-10,36047021200,11219
212,2010,4,55,41,59,34,34,-0.067797,-4,0.617647,21,0.617647,21,36047021200,11219
212,2010,5,61,55,61,27,27,0,0,1.259259,34,1.259259,34,36047021200,11219
214,2001,0,13,13,13,13,13,0,0,0,0,0,0,36047021400,11219
214,2001,1,13,13,13,13,13,0,0,0,0,0,0,36047021400,11219
214,2001,2,18,13,18,18,18,0,0,0,0,0,0,36047021400,11219
214,2001,3,12,18,12,12,12,0,0,0,0,0,0,36047021400,11219
214,2001,4,21,12,21,21,21,0,0,0,0,0,0,36047021400,11219
214,2001,5,10,21,10,10,10,0,0,0,0,0,0,36047021400,11219
214,2002,0,12,12,13,12,12,-0.076923,-1,0,0,0,0,36047021400,11219
214,2002,1,10,12,13,10,10,-0.230769,-3,0,0,0,0,36047021400,11219
214,2002,2,11,10,18,11,11,-0.388889,-7,0,0,0,0,36047021400,11219
214,2002,3,18,11,12,18,18,0.5,6,0,0,0,0,36047021400,11219
214,2002,4,11,18,21,11,11,-0.47619,-10,0,0,0,0,36047021400,11219
214,2002,5,21,11,10,21,21,1.1,11,0,0,0,0,36047021400,11219
214,2003,0,10,10,12,10,10,-0.166667,-2,0,0,0,0,36047021400,11219
214,2003,1,14,10,10,14,14,0.4,4,0,0,0,0,36047021400,11219
214,2003,2,11,14,11,11,11,0,0,0,0,0,0,36047021400,11219
214,2003,3,8,11,18,8,8,-0.555556,-10,0,0,0,0,36047021400,11219
214,2003,4,16,8,11,16,16,0.454545,5,0,0,0,0,36047021400,11219
214,2003,5,12,16,21,12,12,-0.428571,-9,0,0,0,0,36047021400,11219
214,2004,0,12,12,10,13,13,0.2,2,-0.076923,-1,-0.076923,-1,36047021400,11219
214,2004,1,10,12,14,13,13,-0.285714,-4,-0.230769,-3,-0.230769,-3,36047021400,11219
214,2004,2,14,10,11,18,18,0.272727,3,-0.222222,-4,-0.222222,-4,36047021400,11219
214,2004,3,14,14,8,12,12,0.75,6,0.166667,2,0.166667,2,36047021400,11219
214,2004,4,13,14,16,21,21,-0.1875,-3,-0.380952,-8,-0.380952,-8,36047021400,11219
214,2004,5,17,13,12,10,10,0.416667,5,0.7,7,0.7,7,36047021400,11219
214,2005,0,15,15,12,12,12,0.25,3,0.25,3,0.25,3,36047021400,11219
214,2005,1,12,15,10,10,10,0.2,2,0.2,2,0.2,2,36047021400,11219
214,2005,2,11,12,14,11,11,-0.214286,-3,0,0,0,0,36047021400,11219
214,2005,3,15,11,14,18,18,0.071429,1,-0.166667,-3,-0.166667,-3,36047021400,11219
214,2005,4,13,15,13,11,11,0,0,0.181818,2,0.181818,2,36047021400,11219
214,2005,5,14,13,17,21,21,-0.176471,-3,-0.333333,-7,-0.333333,-7,36047021400,11219
214,2006,0,17,17,15,10,10,0.133333,2,0.7,7,0.7,7,36047021400,11219
214,2006,1,19,17,12,14,14,0.583333,7,0.357143,5,0.357143,5,36047021400,11219
214,2006,2,17,19,11,11,11,0.545455,6,0.545455,6,0.545455,6,36047021400,11219
214,2006,3,14,17,15,8,8,-0.066667,-1,0.75,6,0.75,6,36047021400,11219
214,2006,4,15,14,13,16,16,0.153846,2,-0.0625,-1,-0.0625,-1,36047021400,11219
214,2006,5,13,15,14,12,12,-0.071429,-1,0.083333,1,0.083333,1,36047021400,11219
214,2007,0,16,16,17,12,12,-0.058824,-1,0.333333,4,0.333333,4,36047021400,11219
214,2007,1,19,16,19,10,10,0,0,0.9,9,0.9,9,36047021400,11219
214,2007,2,19,19,17,14,14,0.117647,2,0.357143,5,0.357143,5,36047021400,11219
214,2007,3,17,19,14,14,14,0.214286,3,0.214286,3,0.214286,3,36047021400,11219
214,2007,4,19,17,15,13,13,0.266667,4,0.461538,6,0.461538,6,36047021400,11219
214,2007,5,13,19,13,17,17,0,0,-0.235294,-4,-0.235294,-4,36047021400,11219
214,2008,0,17,17,16,15,15,0.0625,1,0.133333,2,0.133333,2,36047021400,11219
214,2008,1,16,17,19,12,12,-0.157895,-3,0.333333,4,0.333333,4,36047021400,11219
214,2008,2,20,16,19,11,11,0.052632,1,0.818182,9,0.818182,9,36047021400,11219
214,2008,3,14,20,17,15,15,-0.176471,-3,-0.066667,-1,-0.066667,-1,36047021400,11219
214,2008,4,20,14,19,13,13,0.052632,1,0.538462,7,0.538462,7,36047021400,11219
214,2008,5,23,20,13,14,14,0.769231,10,0.642857,9,0.642857,9,36047021400,11219
214,2009,0,26,26,17,17,17,0.529412,9,0.529412,9,0.529412,9,36047021400,11219
214,2009,1,29,26,16,19,19,0.8125,13,0.526316,10,0.526316,10,36047021400,11219
214,2009,2,20,29,20,17,17,0,0,0.176471,3,0.176471,3,36047021400,11219
214,2009,3,20,20,14,14,14,0.428571,6,0.428571,6,0.428571,6,36047021400,11219
214,2009,4,22,20,20,15,15,0.1,2,0.466667,7,0.466667,7,36047021400,11219
214,2009,5,23,22,23,13,13,0,0,0.769231,10,0.769231,10,36047021400,11219
214,2010,0,32,32,26,16,16,0.230769,6,1,16,1,16,36047021400,11219
214,2010,1,32,32,29,19,19,0.103448,3,0.684211,13,0.684211,13,36047021400,11219
214,2010,2,26,32,20,19,19,0.3,6,0.368421,7,0.368421,7,36047021400,11219
214,2010,3,25,26,20,17,17,0.25,5,0.470588,8,0.470588,8,36047021400,11219
214,2010,4,19,25,22,19,19,-0.136364,-3,0,0,0,0,36047021400,11219
214,2010,5,24,19,23,13,13,0.043478,1,0.846154,11,0.846154,11,36047021400,11219
216,2001,0,14,14,14,14,14,0,0,0,0,0,0,36047021600,11219
216,2001,1,13,14,13,13,13,0,0,0,0,0,0,36047021600,11219
216,2001,2,9,13,9,9,9,0,0,0,0,0,0,36047021600,11219
216,2001,3,13,9,13,13,13,0,0,0,0,0,0,36047021600,11219
216,2001,4,12,13,12,12,12,0,0,0,0,0,0,36047021600,11219
216,2001,5,10,12,10,10,10,0,0,0,0,0,0,36047021600,11219
216,2002,0,8,8,14,8,8,-0.428571,-6,0,0,0,0,36047021600,11219
216,2002,1,14,8,13,14,14,0.076923,1,0,0,0,0,36047021600,11219
216,2002,2,12,14,9,12,12,0.333333,3,0,0,0,0,36047021600,11219
216,2002,3,8,12,13,8,8,-0.384615,-5,0,0,0,0,36047021600,11219
216,2002,4,13,8,12,13,13,0.083333,1,0,0,0,0,36047021600,11219
216,2002,5,6,13,10,6,6,-0.4,-4,0,0,0,0,36047021600,11219
216,2003,0,14,14,8,14,14,0.75,6,0,0,0,0,36047021600,11219
216,2003,1,10,14,14,10,10,-0.285714,-4,0,0,0,0,36047021600,11219
216,2003,2,14,10,12,14,14,0.166667,2,0,0,0,0,36047021600,11219
216,2003,3,13,14,8,13,13,0.625,5,0,0,0,0,36047021600,11219
216,2003,4,10,13,13,10,10,-0.230769,-3,0,0,0,0,36047021600,11219
216,2003,5,14,10,6,14,14,1.333333,8,0,0,0,0,36047021600,11219
216,2004,0,12,12,14,14,14,-0.142857,-2,-0.142857,-2,-0.142857,-2,36047021600,11219
216,2004,1,16,12,10,13,13,0.6,6,0.230769,3,0.230769,3,36047021600,11219
216,2004,2,10,16,14,9,9,-0.285714,-4,0.111111,1,0.111111,1,36047021600,11219
216,2004,3,12,10,13,13,13,-0.076923,-1,-0.076923,-1,-0.076923,-1,36047021600,11219
216,2004,4,11,12,10,12,12,0.1,1,-0.083333,-1,-0.083333,-1,36047021600,11219
216,2004,5,8,11,14,10,10,-0.428571,-6,-0.2,-2,-0.2,-2,36047021600,11219
216,2005,0,15,15,12,8,8,0.25,3,0.875,7,0.875,7,36047021600,11219
216,2005,1,12,15,16,14,14,-0.25,-4,-0.142857,-2,-0.142857,-2,36047021600,11219
216,2005,2,14,12,10,12,12,0.4,4,0.166667,2,0.166667,2,36047021600,11219
216,2005,3,11,14,12,8,8,-0.083333,-1,0.375,3,0.375,3,36047021600,11219
216,2005,4,13,11,11,13,13,0.181818,2,0,0,0,0,36047021600,11219
216,2005,5,13,13,8,6,6,0.625,5,1.166667,7,1.166667,7,36047021600,11219
216,2006,0,11,11,15,14,14,-0.266667,-4,-0.214286,-3,-0.214286,-3,36047021600,11219
216,2006,1,15,11,12,10,10,0.25,3,0.5,5,0.5,5,36047021600,11219
216,2006,2,14,15,14,14,14,0,0,0,0,0,0,36047021600,11219
216,2006,3,17,14,11,13,13,0.545455,6,0.307692,4,0.307692,4,36047021600,11219
216,2006,4,14,17,13,10,10,0.076923,1,0.4,4,0.4,4,36047021600,11219
216,2006,5,20,14,13,14,14,0.538462,7,0.428571,6,0.428571,6,36047021600,11219
216,2007,0,9,9,11,12,12,-0.181818,-2,-0.25,-3,-0.25,-3,36047021600,11219
216,2007,1,11,9,15,16,16,-0.266667,-4,-0.3125,-5,-0.3125,-5,36047021600,11219
216,2007,2,10,11,14,10,10,-0.285714,-4,0,0,0,0,36047021600,11219
216,2007,3,10,10,17,12,12,-0.411765,-7,-0.166667,-2,-0.166667,-2,36047021600,11219
216,2007,4,18,10,14,11,11,0.285714,4,0.636364,7,0.636364,7,36047021600,11219
216,2007,5,14,18,20,8,8,-0.3,-6,0.75,6,0.75,6,36047021600,11219
216,2008,0,11,11,9,15,15,0.222222,2,-0.266667,-4,-0.266667,-4,36047021600,11219
216,2008,1,3,11,11,12,12,-0.727273,-8,-0.75,-9,-0.75,-9,36047021600,11219
216,2008,2,9,3,10,14,14,-0.1,-1,-0.357143,-5,-0.357143,-5,36047021600,11219
216,2008,3,10,9,10,11,11,0,0,-0.090909,-1,-0.090909,-1,36047021600,11219
216,2008,4,9,10,18,13,13,-0.5,-9,-0.307692,-4,-0.307692,-4,36047021600,11219
216,2008,5,13,9,14,13,13,-0.071429,-1,0,0,0,0,36047021600,11219
216,2009,0,16,16,11,11,11,0.454545,5,0.454545,5,0.454545,5,36047021600,11219
216,2009,1,12,16,3,15,15,3,9,-0.2,-3,-0.2,-3,36047021600,11219
216,2009,2,10,12,9,14,14,0.111111,1,-0.285714,-4,-0.285714,-4,36047021600,11219
216,2009,3,12,10,10,17,17,0.2,2,-0.294118,-5,-0.294118,-5,36047021600,11219
216,2009,4,10,12,9,14,14,0.111111,1,-0.285714,-4,-0.285714,-4,36047021600,11219
216,2009,5,12,10,13,20,20,-0.076923,-1,-0.4,-8,-0.4,-8,36047021600,11219
216,2010,0,17,17,16,9,9,0.0625,1,0.888889,8,0.888889,8,36047021600,11219
216,2010,1,16,17,12,11,11,0.333333,4,0.454545,5,0.454545,5,36047021600,11219
216,2010,2,15,16,10,10,10,0.5,5,0.5,5,0.5,5,36047021600,11219
216,2010,3,8,15,12,10,10,-0.333333,-4,-0.2,-2,-0.2,-2,36047021600,11219
216,2010,4,14,8,10,18,18,0.4,4,-0.222222,-4,-0.222222,-4,36047021600,11219
216,2010,5,14,14,12,14,14,0.166667,2,0,0,0,0,36047021600,11219
218,2001,0,10,10,10,10,10,0,0,0,0,0,0,36047021800,11219
218,2001,1,13,10,13,13,13,0,0,0,0,0,0,36047021800,11219
218,2001,2,14,13,14,14,14,0,0,0,0,0,0,36047021800,11219
218,2001,3,10,14,10,10,10,0,0,0,0,0,0,36047021800,11219
218,2001,4,9,10,9,9,9,0,0,0,0,0,0,36047021800,11219
218,2001,5,10,9,10,10,10,0,0,0,0,0,0,36047021800,11219
218,2002,0,6,6,10,6,6,-0.4,-4,0,0,0,0,36047021800,11219
218,2002,1,7,6,13,7,7,-0.461538,-6,0,0,0,0,36047021800,11219
218,2002,2,13,7,14,13,13,-0.071429,-1,0,0,0,0,36047021800,11219
218,2002,3,11,13,10,11,11,0.1,1,0,0,0,0,36047021800,11219
218,2002,4,7,11,9,7,7,-0.222222,-2,0,0,0,0,36047021800,11219
218,2002,5,11,7,10,11,11,0.1,1,0,0,0,0,36047021800,11219
218,2003,0,15,15,6,15,15,1.5,9,0,0,0,0,36047021800,11219
218,2003,1,8,15,7,8,8,0.142857,1,0,0,0,0,36047021800,11219
218,2003,2,12,8,13,12,12,-0.076923,-1,0,0,0,0,36047021800,11219
218,2003,3,12,12,11,12,12,0.090909,1,0,0,0,0,36047021800,11219
218,2003,4,10,12,7,10,10,0.428571,3,0,0,0,0,36047021800,11219
218,2003,5,6,10,11,6,6,-0.454545,-5,0,0,0,0,36047021800,11219
218,2004,0,10,10,15,10,10,-0.333333,-5,0,0,0,0,36047021800,11219
218,2004,1,14,10,8,13,13,0.75,6,0.076923,1,0.076923,1,36047021800,11219
218,2004,2,13,14,12,14,14,0.083333,1,-0.071429,-1,-0.071429,-1,36047021800,11219
218,2004,3,8,13,12,10,10,-0.333333,-4,-0.2,-2,-0.2,-2,36047021800,11219
218,2004,4,14,8,10,9,9,0.4,4,0.555556,5,0.555556,5,36047021800,11219
218,2004,5,7,14,6,10,10,0.166667,1,-0.3,-3,-0.3,-3,36047021800,11219
218,2005,0,9,9,10,6,6,-0.1,-1,0.5,3,0.5,3,36047021800,11219
218,2005,1,6,9,14,7,7,-0.571429,-8,-0.142857,-1,-0.142857,-1,36047021800,11219
218,2005,2,12,6,13,13,13,-0.076923,-1,-0.076923,-1,-0.076923,-1,36047021800,11219
218,2005,3,15,12,8,11,11,0.875,7,0.363636,4,0.363636,4,36047021800,11219
218,2005,4,11,15,14,7,7,-0.214286,-3,0.571429,4,0.571429,4,36047021800,11219
218,2005,5,13,11,7,11,11,0.857143,6,0.181818,2,0.181818,2,36047021800,11219
218,2006,0,14,14,9,15,15,0.555556,5,-0.066667,-1,-0.066667,-1,36047021800,11219
218,2006,1,7,14,6,8,8,0.166667,1,-0.125,-1,-0.125,-1,36047021800,11219
218,2006,2,7,7,12,12,12,-0.416667,-5,-0.416667,-5,-0.416667,-5,36047021800,11219
218,2006,3,15,7,15,12,12,0,0,0.25,3,0.25,3,36047021800,11219
218,2006,4,13,15,11,10,10,0.181818,2,0.3,3,0.3,3,36047021800,11219
218,2006,5,13,13,13,6,6,0,0,1.166667,7,1.166667,7,36047021800,11219
218,2007,0,11,11,14,10,10,-0.214286,-3,0.1,1,0.1,1,36047021800,11219
218,2007,1,13,11,7,14,14,0.857143,6,-0.071429,-1,-0.071429,-1,36047021800,11219
218,2007,2,8,13,7,13,13,0.142857,1,-0.384615,-5,-0.384615,-5,36047021800,11219
218,2007,3,7,8,15,8,8,-0.533333,-8,-0.125,-1,-0.125,-1,36047021800,11219
218,2007,4,14,7,13,14,14,0.076923,1,0,0,0,0,36047021800,11219
218,2007,5,12,14,13,7,7,-0.076923,-1,0.714286,5,0.714286,5,36047021800,11219
218,2008,0,7,7,11,9,9,-0.363636,-4,-0.222222,-2,-0.222222,-2,36047021800,11219
218,2008,1,10,7,13,6,6,-0.230769,-3,0.666667,4,0.666667,4,36047021800,11219
218,2008,2,13,10,8,12,12,0.625,5,0.083333,1,0.083333,1,36047021800,11219
218,2008,3,6,13,7,15,15,-0.142857,-1,-0.6,-9,-0.6,-9,36047021800,11219
218,2008,4,6,6,14,11,11,-0.571429,-8,-0.454545,-5,-0.454545,-5,36047021800,11219
218,2008,5,11,6,12,13,13,-0.083333,-1,-0.153846,-2,-0.153846,-2,36047021800,11219
218,2009,0,9,9,7,14,14,0.285714,2,-0.357143,-5,-0.357143,-5,36047021800,11219
218,2009,1,8,9,10,7,7,-0.2,-2,0.142857,1,0.142857,1,36047021800,11219
218,2009,2,10,8,13,7,7,-0.230769,-3,0.428571,3,0.428571,3,36047021800,11219
218,2009,3,9,10,6,15,15,0.5,3,-0.4,-6,-0.4,-6,36047021800,11219
218,2009,4,5,9,6,13,13,-0.166667,-1,-0.615385,-8,-0.615385,-8,36047021800,11219
218,2009,5,6,5,11,13,13,-0.454545,-5,-0.538462,-7,-0.538462,-7,36047021800,11219
218,2010,0,17,17,9,11,11,0.888889,8,0.545455,6,0.545455,6,36047021800,11219
218,2010,1,13,17,8,13,13,0.625,5,0,0,0,0,36047021800,11219
218,2010,2,8,13,10,8,8,-0.2,-2,0,0,0,0,36047021800,11219
218,2010,3,12,8,9,7,7,0.333333,3,0.714286,5,0.714286,5,36047021800,11219
218,2010,4,9,12,5,14,14,0.8,4,-0.357143,-5,-0.357143,-5,36047021800,11219
218,2010,5,3,9,6,12,12,-0.5,-3,-0.75,-9,-0.75,-9,36047021800,11219
220,2001,0,12,12,12,12,12,0,0,0,0,0,0,36047022000,11219
220,2001,1,12,12,12,12,12,0,0,0,0,0,0,36047022000,11219
220,2001,2,9,12,9,9,9,0,0,0,0,0,0,36047022000,11219
220,2001,3,8,9,8,8,8,0,0,0,0,0,0,36047022000,11219
220,2001,4,8,8,8,8,8,0,0,0,0,0,0,36047022000,11219
220,2001,5,9,8,9,9,9,0,0,0,0,0,0,36047022000,11219
220,2002,0,12,12,12,12,12,0,0,0,0,0,0,36047022000,11219
220,2002,1,12,12,12,12,12,0,0,0,0,0,0,36047022000,11219
220,2002,2,12,12,9,12,12,0.333333,3,0,0,0,0,36047022000,11219
220,2002,3,6,12,8,6,6,-0.25,-2,0,0,0,0,36047022000,11219
220,2002,4,6,6,8,6,6,-0.25,-2,0,0,0,0,36047022000,11219
220,2002,5,7,6,9,7,7,-0.222222,-2,0,0,0,0,36047022000,11219
220,2003,0,10,10,12,10,10,-0.166667,-2,0,0,0,0,36047022000,11219
220,2003,1,13,10,12,13,13,0.083333,1,0,0,0,0,36047022000,11219
220,2003,2,15,13,12,15,15,0.25,3,0,0,0,0,36047022000,11219
220,2003,3,11,15,6,11,11,0.833333,5,0,0,0,0,36047022000,11219
220,2003,4,7,11,6,7,7,0.166667,1,0,0,0,0,36047022000,11219
220,2003,5,6,7,7,6,6,-0.142857,-1,0,0,0,0,36047022000,11219
220,2004,0,11,11,10,12,12,0.1,1,-0.083333,-1,-0.083333,-1,36047022000,11219
220,2004,1,14,11,13,12,12,0.076923,1,0.166667,2,0.166667,2,36047022000,11219
220,2004,2,9,14,15,9,9,-0.4,-6,0,0,0,0,36047022000,11219
220,2004,3,12,9,11,8,8,0.090909,1,0.5,4,0.5,4,36047022000,11219
220,2004,4,11,12,7,8,8,0.571429,4,0.375,3,0.375,3,36047022000,11219
220,2004,5,7,11,6,9,9,0.166667,1,-0.222222,-2,-0.222222,-2,36047022000,11219
220,2005,0,5,5,11,12,12,-0.545455,-6,-0.583333,-7,-0.583333,-7,36047022000,11219
220,2005,1,14,5,14,12,12,0,0,0.166667,2,0.166667,2,36047022000,11219
220,2005,2,13,14,9,12,12,0.444444,4,0.083333,1,0.083333,1,36047022000,11219
220,2005,3,10,13,12,6,6,-0.166667,-2,0.666667,4,0.666667,4,36047022000,11219
220,2005,4,14,10,11,6,6,0.272727,3,1.333333,8,1.333333,8,36047022000,11219
220,2005,5,9,14,7,7,7,0.285714,2,0.285714,2,0.285714,2,36047022000,11219
220,2006,0,11,11,5,10,10,1.2,6,0.1,1,0.1,1,36047022000,11219
220,2006,1,5,11,14,13,13,-0.642857,-9,-0.615385,-8,-0.615385,-8,36047022000,11219
220,2006,2,16,5,13,15,15,0.230769,3,0.066667,1,0.066667,1,36047022000,11219
220,2006,3,14,16,10,11,11,0.4,4,0.272727,3,0.272727,3,36047022000,11219
220,2006,4,8,14,14,7,7,-0.428571,-6,0.142857,1,0.142857,1,36047022000,11219
220,2006,5,12,8,9,6,6,0.333333,3,1,6,1,6,36047022000,11219
220,2007,0,7,7,11,11,11,-0.363636,-4,-0.363636,-4,-0.363636,-4,36047022000,11219
220,2007,1,12,7,5,14,14,1.4,7,-0.142857,-2,-0.142857,-2,36047022000,11219
220,2007,2,6,12,16,9,9,-0.625,-10,-0.333333,-3,-0.333333,-3,36047022000,11219
220,2007,3,14,6,14,12,12,0,0,0.166667,2,0.166667,2,36047022000,11219
220,2007,4,13,14,8,11,11,0.625,5,0.181818,2,0.181818,2,36047022000,11219
220,2007,5,9,13,12,7,7,-0.25,-3,0.285714,2,0.285714,2,36047022000,11219
220,2008,0,6,6,7,5,5,-0.142857,-1,0.2,1,0.2,1,36047022000,11219
220,2008,1,6,6,12,14,14,-0.5,-6,-0.571429,-8,-0.571429,-8,36047022000,11219
220,2008,2,10,6,6,13,13,0.666667,4,-0.230769,-3,-0.230769,-3,36047022000,11219
220,2008,3,7,10,14,10,10,-0.5,-7,-0.3,-3,-0.3,-3,36047022000,11219
220,2008,4,14,7,13,14,14,0.076923,1,0,0,0,0,36047022000,11219
220,2008,5,11,14,9,9,9,0.222222,2,0.222222,2,0.222222,2,36047022000,11219
220,2009,0,14,14,6,11,11,1.333333,8,0.272727,3,0.272727,3,36047022000,11219
220,2009,1,9,14,6,5,5,0.5,3,0.8,4,0.8,4,36047022000,11219
220,2009,2,14,9,10,16,16,0.4,4,-0.125,-2,-0.125,-2,36047022000,11219
220,2009,3,11,14,7,14,14,0.571429,4,-0.214286,-3,-0.214286,-3,36047022000,11219
220,2009,4,5,11,14,8,8,-0.642857,-9,-0.375,-3,-0.375,-3,36047022000,11219
220,2009,5,12,5,11,12,12,0.090909,1,0,0,0,0,36047022000,11219
220,2010,0,16,16,14,7,7,0.142857,2,1.285714,9,1.285714,9,36047022000,11219
220,2010,1,16,16,9,12,12,0.777778,7,0.333333,4,0.333333,4,36047022000,11219
220,2010,2,9,16,14,6,6,-0.357143,-5,0.5,3,0.5,3,36047022000,11219
220,2010,3,12,9,11,14,14,0.090909,1,-0.142857,-2,-0.142857,-2,36047022000,11219
220,2010,4,11,12,5,13,13,1.2,6,-0.153846,-2,-0.153846,-2,36047022000,11219
220,2010,5,4,11,12,9,9,-0.666667,-8,-0.555556,-5,-0.555556,-5,36047022000,11219
221,2007,0,1,1,0,0,0,1,1,1,1,1,1,36047022100,11216
221,2008,1,1,0,0,0,0,1,1,1,1,1,1,36047022100,11216
221,2009,2,1,0,0,0,0,1,1,1,1,1,1,36047022100,11216
221,2010,3,1,0,0,0,0,1,1,1,1,1,1,36047022100,11216
222,2001,0,2,2,2,2,2,0,0,0,0,0,0,36047022200,11219
222,2001,1,8,2,8,8,8,0,0,0,0,0,0,36047022200,11219
222,2001,2,2,8,2,2,2,0,0,0,0,0,0,36047022200,11219
222,2001,4,2,0,2,2,2,0,0,0,0,0,0,36047022200,11219
222,2001,5,6,2,6,6,6,0,0,0,0,0,0,36047022200,11219
222,2002,0,4,4,2,4,4,1,2,0,0,0,0,36047022200,11219
222,2002,1,3,4,8,3,3,-0.625,-5,0,0,0,0,36047022200,11219
222,2002,2,5,3,2,5,5,1.5,3,0,0,0,0,36047022200,11219
222,2002,3,2,5,0,2,2,1,2,0,0,0,0,36047022200,11219
222,2002,5,2,0,6,2,2,-0.666667,-4,0,0,0,0,36047022200,11219
222,2003,0,1,1,4,1,1,-0.75,-3,0,0,0,0,36047022200,11219
222,2003,1,4,1,3,4,4,0.333333,1,0,0,0,0,36047022200,11219
222,2003,2,3,4,5,3,3,-0.4,-2,0,0,0,0,36047022200,11219
222,2003,3,6,3,2,6,6,2,4,0,0,0,0,36047022200,11219
222,2003,4,2,6,0,2,2,1,2,0,0,0,0,36047022200,11219
222,2004,0,11,11,1,2,2,10,10,4.5,9,4.5,9,36047022200,11219
222,2004,1,1,11,4,8,8,-0.75,-3,-0.875,-7,-0.875,-7,36047022200,11219
222,2004,2,5,1,3,2,2,0.666667,2,1.5,3,1.5,3,36047022200,11219
222,2004,3,3,5,6,0,0,-0.5,-3,1,3,1,3,36047022200,11219
222,2004,4,5,3,2,2,2,1.5,3,1.5,3,1.5,3,36047022200,11219
222,2004,5,3,5,6,6,6,-0.5,-3,-0.5,-3,-0.5,-3,36047022200,11219
222,2005,0,4,4,11,4,4,-0.636364,-7,0,0,0,0,36047022200,11219
222,2005,1,8,4,1,3,3,7,7,1.666667,5,1.666667,5,36047022200,11219
222,2005,2,1,8,5,5,5,-0.8,-4,-0.8,-4,-0.8,-4,36047022200,11219
222,2005,3,4,1,3,2,2,0.333333,1,1,2,1,2,36047022200,11219
222,2005,4,4,4,5,0,0,-0.2,-1,1,4,1,4,36047022200,11219
222,2005,5,6,4,3,2,2,1,3,2,4,2,4,36047022200,11219
222,2006,0,6,6,4,1,1,0.5,2,5,5,5,5,36047022200,11219
222,2006,1,4,6,8,4,4,-0.5,-4,0,0,0,0,36047022200,11219
222,2006,2,7,4,1,3,3,6,6,1.333333,4,1.333333,4,36047022200,11219
222,2006,3,2,7,4,6,6,-0.5,-2,-0.666667,-4,-0.666667,-4,36047022200,11219
222,2006,4,4,2,4,2,2,0,0,1,2,1,2,36047022200,11219
222,2006,5,6,4,6,0,0,0,0,1,6,1,6,36047022200,11219
222,2007,0,3,3,6,11,11,-0.5,-3,-0.727273,-8,-0.727273,-8,36047022200,11219
222,2007,1,6,3,4,1,1,0.5,2,5,5,5,5,36047022200,11219
222,2007,2,4,6,7,5,5,-0.428571,-3,-0.2,-1,-0.2,-1,36047022200,11219
222,2007,3,7,4,2,3,3,2.5,5,1.333333,4,1.333333,4,36047022200,11219
222,2007,4,2,7,4,5,5,-0.5,-2,-0.6,-3,-0.6,-3,36047022200,11219
222,2007,5,4,2,6,3,3,-0.333333,-2,0.333333,1,0.333333,1,36047022200,11219
222,2008,0,5,5,3,4,4,0.666667,2,0.25,1,0.25,1,36047022200,11219
222,2008,1,2,5,6,8,8,-0.666667,-4,-0.75,-6,-0.75,-6,36047022200,11219
222,2008,2,9,2,4,1,1,1.25,5,8,8,8,8,36047022200,11219
222,2008,3,5,9,7,4,4,-0.285714,-2,0.25,1,0.25,1,36047022200,11219
222,2008,4,7,5,2,4,4,2.5,5,0.75,3,0.75,3,36047022200,11219
222,2008,5,3,7,4,6,6,-0.25,-1,-0.5,-3,-0.5,-3,36047022200,11219
222,2009,0,4,4,5,6,6,-0.2,-1,-0.333333,-2,-0.333333,-2,36047022200,11219
222,2009,1,8,4,2,4,4,3,6,1,4,1,4,36047022200,11219
222,2009,2,4,8,9,7,7,-0.555556,-5,-0.428571,-3,-0.428571,-3,36047022200,11219
222,2009,3,8,4,5,2,2,0.6,3,3,6,3,6,36047022200,11219
222,2009,4,5,8,7,4,4,-0.285714,-2,0.25,1,0.25,1,36047022200,11219
222,2009,5,7,5,3,6,6,1.333333,4,0.166667,1,0.166667,1,36047022200,11219
222,2010,0,2,2,4,3,3,-0.5,-2,-0.333333,-1,-0.333333,-1,36047022200,11219
222,2010,1,4,2,8,6,6,-0.5,-4,-0.333333,-2,-0.333333,-2,36047022200,11219
222,2010,2,8,4,4,4,4,1,4,1,4,1,4,36047022200,11219
222,2010,3,4,8,8,7,7,-0.5,-4,-0.428571,-3,-0.428571,-3,36047022200,11219
222,2010,4,8,4,5,2,2,0.6,3,3,6,3,6,36047022200,11219
222,2010,5,5,8,7,4,4,-0.285714,-2,0.25,1,0.25,1,36047022200,11219
228,2001,0,6,6,6,6,6,0,0,0,0,0,0,36047022800,11218
228,2001,1,7,6,7,7,7,0,0,0,0,0,0,36047022800,11218
228,2001,2,4,7,4,4,4,0,0,0,0,0,0,36047022800,11218
228,2001,3,5,4,5,5,5,0,0,0,0,0,0,36047022800,11218
228,2001,4,10,5,10,10,10,0,0,0,0,0,0,36047022800,11218
228,2001,5,3,10,3,3,3,0,0,0,0,0,0,36047022800,11218
228,2002,0,1,1,6,1,1,-0.833333,-5,0,0,0,0,36047022800,11218
228,2002,1,4,1,7,4,4,-0.428571,-3,0,0,0,0,36047022800,11218
228,2002,2,6,4,4,6,6,0.5,2,0,0,0,0,36047022800,11218
228,2002,3,2,6,5,2,2,-0.6,-3,0,0,0,0,36047022800,11218
228,2002,4,3,2,10,3,3,-0.7,-7,0,0,0,0,36047022800,11218
228,2002,5,7,3,3,7,7,1.333333,4,0,0,0,0,36047022800,11218
228,2003,0,4,4,1,4,4,3,3,0,0,0,0,36047022800,11218
228,2003,1,2,4,4,2,2,-0.5,-2,0,0,0,0,36047022800,11218
228,2003,2,6,2,6,6,6,0,0,0,0,0,0,36047022800,11218
228,2003,3,4,6,2,4,4,1,2,0,0,0,0,36047022800,11218
228,2003,4,1,4,3,1,1,-0.666667,-2,0,0,0,0,36047022800,11218
228,2003,5,4,1,7,4,4,-0.428571,-3,0,0,0,0,36047022800,11218
228,2004,0,6,6,4,6,6,0.5,2,0,0,0,0,36047022800,11218
228,2004,1,4,6,2,7,7,1,2,-0.428571,-3,-0.428571,-3,36047022800,11218
228,2004,2,1,4,6,4,4,-0.833333,-5,-0.75,-3,-0.75,-3,36047022800,11218
228,2004,3,6,1,4,5,5,0.5,2,0.2,1,0.2,1,36047022800,11218
228,2004,4,5,6,1,10,10,4,4,-0.5,-5,-0.5,-5,36047022800,11218
228,2004,5,1,5,4,3,3,-0.75,-3,-0.666667,-2,-0.666667,-2,36047022800,11218
228,2005,0,3,3,6,1,1,-0.5,-3,2,2,2,2,36047022800,11218
228,2005,1,7,3,4,4,4,0.75,3,0.75,3,0.75,3,36047022800,11218
228,2005,2,3,7,1,6,6,2,2,-0.5,-3,-0.5,-3,36047022800,11218
228,2005,3,3,3,6,2,2,-0.5,-3,0.5,1,0.5,1,36047022800,11218
228,2005,4,5,3,5,3,3,0,0,0.666667,2,0.666667,2,36047022800,11218
228,2005,5,5,5,1,7,7,4,4,-0.285714,-2,-0.285714,-2,36047022800,11218
228,2006,0,2,2,3,4,4,-0.333333,-1,-0.5,-2,-0.5,-2,36047022800,11218
228,2006,1,3,2,7,2,2,-0.571429,-4,0.5,1,0.5,1,36047022800,11218
228,2006,2,3,3,3,6,6,0,0,-0.5,-3,-0.5,-3,36047022800,11218
228,2006,3,3,3,3,4,4,0,0,-0.25,-1,-0.25,-1,36047022800,11218
228,2006,4,3,3,5,1,1,-0.4,-2,2,2,2,2,36047022800,11218
228,2006,5,4,3,5,4,4,-0.2,-1,0,0,0,0,36047022800,11218
228,2007,0,4,4,2,6,6,1,2,-0.333333,-2,-0.333333,-2,36047022800,11218
228,2007,1,3,4,3,4,4,0,0,-0.25,-1,-0.25,-1,36047022800,11218
228,2007,2,4,3,3,1,1,0.333333,1,3,3,3,3,36047022800,11218
228,2007,3,4,4,3,6,6,0.333333,1,-0.333333,-2,-0.333333,-2,36047022800,11218
228,2007,4,5,4,3,5,5,0.666667,2,0,0,0,0,36047022800,11218
228,2008,0,2,2,4,3,3,-0.5,-2,-0.333333,-1,-0.333333,-1,36047022800,11218
228,2008,1,3,2,3,7,7,0,0,-0.571429,-4,-0.571429,-4,36047022800,11218
228,2008,2,3,3,4,3,3,-0.25,-1,0,0,0,0,36047022800,11218
228,2008,3,4,3,4,3,3,0,0,0.333333,1,0.333333,1,36047022800,11218
228,2008,4,4,4,5,5,5,-0.2,-1,-0.2,-1,-0.2,-1,36047022800,11218
228,2008,5,5,4,5,5,5,0,0,0,0,0,0,36047022800,11218
228,2009,0,2,2,2,2,2,0,0,0,0,0,0,36047022800,11218
228,2009,1,2,2,3,3,3,-0.333333,-1,-0.333333,-1,-0.333333,-1,36047022800,11218
228,2009,2,3,2,3,3,3,0,0,0,0,0,0,36047022800,11218
228,2009,3,3,3,4,3,3,-0.25,-1,0,0,0,0,36047022800,11218
228,2009,4,4,3,4,3,3,0,0,0.333333,1,0.333333,1,36047022800,11218
228,2009,5,4,4,5,4,4,-0.2,-1,0,0,0,0,36047022800,11218
228,2010,0,3,3,2,4,4,0.5,1,-0.25,-1,-0.25,-1,36047022800,11218
228,2010,1,3,3,2,3,3,0.5,1,0,0,0,0,36047022800,11218
228,2010,2,2,3,3,4,4,-0.333333,-1,-0.5,-2,-0.5,-2,36047022800,11218
228,2010,3,3,2,3,4,4,0,0,-0.25,-1,-0.25,-1,36047022800,11218
228,2010,4,3,3,4,5,5,-0.25,-1,-0.4,-2,-0.4,-2,36047022800,11218
228,2010,5,4,3,4,0,0,0,0,1,4,1,4,36047022800,11218
230,2001,0,41,41,41,41,41,0,0,0,0,0,0,36047023000,11204
230,2001,1,36,41,36,36,36,0,0,0,0,0,0,36047023000,11204
230,2001,2,29,36,29,29,29,0,0,0,0,0,0,36047023000,11204
230,2001,3,18,29,18,18,18,0,0,0,0,0,0,36047023000,11204
230,2001,4,23,18,23,23,23,0,0,0,0,0,0,36047023000,11204
230,2001,5,21,23,21,21,21,0,0,0,0,0,0,36047023000,11204
230,2002,0,40,40,41,40,40,-0.02439,-1,0,0,0,0,36047023000,11204
230,2002,1,43,40,36,43,43,0.194444,7,0,0,0,0,36047023000,11204
230,2002,2,33,43,29,33,33,0.137931,4,0,0,0,0,36047023000,11204
230,2002,3,30,33,18,30,30,0.666667,12,0,0,0,0,36047023000,11204
230,2002,4,17,30,23,17,17,-0.26087,-6,0,0,0,0,36047023000,11204
230,2002,5,22,17,21,22,22,0.047619,1,0,0,0,0,36047023000,11204
230,2003,0,31,31,40,31,31,-0.225,-9,0,0,0,0,36047023000,11204
230,2003,1,34,31,43,34,34,-0.209302,-9,0,0,0,0,36047023000,11204
230,2003,2,33,34,33,33,33,0,0,0,0,0,0,36047023000,11204
230,2003,3,33,33,30,33,33,0.1,3,0,0,0,0,36047023000,11204
230,2003,4,23,33,17,23,23,0.352941,6,0,0,0,0,36047023000,11204
230,2003,5,20,23,22,20,20,-0.090909,-2,0,0,0,0,36047023000,11204
230,2004,0,32,32,31,41,41,0.032258,1,-0.219512,-9,-0.219512,-9,36047023000,11204
230,2004,1,27,32,34,36,36,-0.205882,-7,-0.25,-9,-0.25,-9,36047023000,11204
230,2004,2,32,27,33,29,29,-0.030303,-1,0.103448,3,0.103448,3,36047023000,11204
230,2004,3,30,32,33,18,18,-0.090909,-3,0.666667,12,0.666667,12,36047023000,11204
230,2004,4,26,30,23,23,23,0.130435,3,0.130435,3,0.130435,3,36047023000,11204
230,2004,5,21,26,20,21,21,0.05,1,0,0,0,0,36047023000,11204
230,2005,0,27,27,32,40,40,-0.15625,-5,-0.325,-13,-0.325,-13,36047023000,11204
230,2005,1,23,27,27,43,43,-0.148148,-4,-0.465116,-20,-0.465116,-20,36047023000,11204
230,2005,2,28,23,32,33,33,-0.125,-4,-0.151515,-5,-0.151515,-5,36047023000,11204
230,2005,3,23,28,30,30,30,-0.233333,-7,-0.233333,-7,-0.233333,-7,36047023000,11204
230,2005,4,30,23,26,17,17,0.153846,4,0.764706,13,0.764706,13,36047023000,11204
230,2005,5,21,30,21,22,22,0,0,-0.045455,-1,-0.045455,-1,36047023000,11204
230,2006,0,27,27,27,31,31,0,0,-0.129032,-4,-0.129032,-4,36047023000,11204
230,2006,1,16,27,23,34,34,-0.304348,-7,-0.529412,-18,-0.529412,-18,36047023000,11204
230,2006,2,24,16,28,33,33,-0.142857,-4,-0.272727,-9,-0.272727,-9,36047023000,11204
230,2006,3,23,24,23,33,33,0,0,-0.30303,-10,-0.30303,-10,36047023000,11204
230,2006,4,26,23,30,23,23,-0.133333,-4,0.130435,3,0.130435,3,36047023000,11204
230,2006,5,23,26,21,20,20,0.095238,2,0.15,3,0.15,3,36047023000,11204
230,2007,0,27,27,27,32,32,0,0,-0.15625,-5,-0.15625,-5,36047023000,11204
230,2007,1,27,27,16,27,27,0.6875,11,0,0,0,0,36047023000,11204
230,2007,2,17,27,24,32,32,-0.291667,-7,-0.46875,-15,-0.46875,-15,36047023000,11204
230,2007,3,22,17,23,30,30,-0.043478,-1,-0.266667,-8,-0.266667,-8,36047023000,11204
230,2007,4,20,22,26,26,26,-0.230769,-6,-0.230769,-6,-0.230769,-6,36047023000,11204
230,2007,5,23,20,23,21,21,0,0,0.095238,2,0.095238,2,36047023000,11204
230,2008,0,18,18,27,27,27,-0.333333,-9,-0.333333,-9,-0.333333,-9,36047023000,11204
230,2008,1,31,18,27,23,23,0.148148,4,0.347826,8,0.347826,8,36047023000,11204
230,2008,2,23,31,17,28,28,0.352941,6,-0.178571,-5,-0.178571,-5,36047023000,11204
230,2008,3,21,23,22,23,23,-0.045455,-1,-0.086957,-2,-0.086957,-2,36047023000,11204
230,2008,4,21,21,20,30,30,0.05,1,-0.3,-9,-0.3,-9,36047023000,11204
230,2008,5,19,21,23,21,21,-0.173913,-4,-0.095238,-2,-0.095238,-2,36047023000,11204
230,2009,0,23,23,18,27,27,0.277778,5,-0.148148,-4,-0.148148,-4,36047023000,11204
230,2009,1,27,23,31,16,16,-0.129032,-4,0.6875,11,0.6875,11,36047023000,11204
230,2009,2,27,27,23,24,24,0.173913,4,0.125,3,0.125,3,36047023000,11204
230,2009,3,25,27,21,23,23,0.190476,4,0.086957,2,0.086957,2,36047023000,11204
230,2009,4,23,25,21,26,26,0.095238,2,-0.115385,-3,-0.115385,-3,36047023000,11204
230,2009,5,24,23,19,23,23,0.263158,5,0.043478,1,0.043478,1,36047023000,11204
230,2010,0,35,35,23,27,27,0.521739,12,0.296296,8,0.296296,8,36047023000,11204
230,2010,1,24,35,27,27,27,-0.111111,-3,-0.111111,-3,-0.111111,-3,36047023000,11204
230,2010,2,26,24,27,17,17,-0.037037,-1,0.529412,9,0.529412,9,36047023000,11204
230,2010,3,22,26,25,22,22,-0.12,-3,0,0,0,0,36047023000,11204
230,2010,4,27,22,23,20,20,0.173913,4,0.35,7,0.35,7,36047023000,11204
230,2010,5,25,27,24,23,23,0.041667,1,0.086957,2,0.086957,2,36047023000,11204
232,2001,0,28,28,28,28,28,0,0,0,0,0,0,36047023200,11204
232,2001,1,23,28,23,23,23,0,0,0,0,0,0,36047023200,11204
232,2001,2,27,23,27,27,27,0,0,0,0,0,0,36047023200,11204
232,2001,3,24,27,24,24,24,0,0,0,0,0,0,36047023200,11204
232,2001,4,21,24,21,21,21,0,0,0,0,0,0,36047023200,11204
232,2001,5,19,21,19,19,19,0,0,0,0,0,0,36047023200,11204
232,2002,0,17,17,28,17,17,-0.392857,-11,0,0,0,0,36047023200,11204
232,2002,1,31,17,23,31,31,0.347826,8,0,0,0,0,36047023200,11204
232,2002,2,25,31,27,25,25,-0.074074,-2,0,0,0,0,36047023200,11204
232,2002,3,27,25,24,27,27,0.125,3,0,0,0,0,36047023200,11204
232,2002,4,22,27,21,22,22,0.047619,1,0,0,0,0,36047023200,11204
232,2002,5,22,22,19,22,22,0.157895,3,0,0,0,0,36047023200,11204
232,2003,0,13,13,17,13,13,-0.235294,-4,0,0,0,0,36047023200,11204
232,2003,1,23,13,31,23,23,-0.258065,-8,0,0,0,0,36047023200,11204
232,2003,2,29,23,25,29,29,0.16,4,0,0,0,0,36047023200,11204
232,2003,3,17,29,27,17,17,-0.37037,-10,0,0,0,0,36047023200,11204
232,2003,4,23,17,22,23,23,0.045455,1,0,0,0,0,36047023200,11204
232,2003,5,20,23,22,20,20,-0.090909,-2,0,0,0,0,36047023200,11204
232,2004,0,23,23,13,28,28,0.769231,10,-0.178571,-5,-0.178571,-5,36047023200,11204
232,2004,1,17,23,23,23,23,-0.26087,-6,-0.26087,-6,-0.26087,-6,36047023200,11204
232,2004,2,20,17,29,27,27,-0.310345,-9,-0.259259,-7,-0.259259,-7,36047023200,11204
232,2004,3,29,20,17,24,24,0.705882,12,0.208333,5,0.208333,5,36047023200,11204
232,2004,4,17,29,23,21,21,-0.26087,-6,-0.190476,-4,-0.190476,-4,36047023200,11204
232,2004,5,22,17,20,19,19,0.1,2,0.157895,3,0.157895,3,36047023200,11204
232,2005,0,13,13,23,17,17,-0.434783,-10,-0.235294,-4,-0.235294,-4,36047023200,11204
232,2005,1,19,13,17,31,31,0.117647,2,-0.387097,-12,-0.387097,-12,36047023200,11204
232,2005,2,13,19,20,25,25,-0.35,-7,-0.48,-12,-0.48,-12,36047023200,11204
232,2005,3,18,13,29,27,27,-0.37931,-11,-0.333333,-9,-0.333333,-9,36047023200,11204
232,2005,4,26,18,17,22,22,0.529412,9,0.181818,4,0.181818,4,36047023200,11204
232,2005,5,12,26,22,22,22,-0.454545,-10,-0.454545,-10,-0.454545,-10,36047023200,11204
232,2006,0,18,18,13,13,13,0.384615,5,0.384615,5,0.384615,5,36047023200,11204
232,2006,1,15,18,19,23,23,-0.210526,-4,-0.347826,-8,-0.347826,-8,36047023200,11204
232,2006,2,14,15,13,29,29,0.076923,1,-0.517241,-15,-0.517241,-15,36047023200,11204
232,2006,3,15,14,18,17,17,-0.166667,-3,-0.117647,-2,-0.117647,-2,36047023200,11204
232,2006,4,15,15,26,23,23,-0.423077,-11,-0.347826,-8,-0.347826,-8,36047023200,11204
232,2006,5,24,15,12,20,20,1,12,0.2,4,0.2,4,36047023200,11204
232,2007,0,21,21,18,23,23,0.166667,3,-0.086957,-2,-0.086957,-2,36047023200,11204
232,2007,1,14,21,15,17,17,-0.066667,-1,-0.176471,-3,-0.176471,-3,36047023200,11204
232,2007,2,10,14,14,20,20,-0.285714,-4,-0.5,-10,-0.5,-10,36047023200,11204
232,2007,3,12,10,15,29,29,-0.2,-3,-0.586207,-17,-0.586207,-17,36047023200,11204
232,2007,4,12,12,15,17,17,-0.2,-3,-0.294118,-5,-0.294118,-5,36047023200,11204
232,2007,5,14,12,24,22,22,-0.416667,-10,-0.363636,-8,-0.363636,-8,36047023200,11204
232,2008,0,16,16,21,13,13,-0.238095,-5,0.230769,3,0.230769,3,36047023200,11204
232,2008,1,17,16,14,19,19,0.214286,3,-0.105263,-2,-0.105263,-2,36047023200,11204
232,2008,2,10,17,10,13,13,0,0,-0.230769,-3,-0.230769,-3,36047023200,11204
232,2008,3,12,10,12,18,18,0,0,-0.333333,-6,-0.333333,-6,36047023200,11204
232,2008,4,12,12,12,26,26,0,0,-0.538462,-14,-0.538462,-14,36047023200,11204
232,2008,5,13,12,14,12,12,-0.071429,-1,0.083333,1,0.083333,1,36047023200,11204
232,2009,0,20,20,16,18,18,0.25,4,0.111111,2,0.111111,2,36047023200,11204
232,2009,1,19,20,17,15,15,0.117647,2,0.266667,4,0.266667,4,36047023200,11204
232,2009,2,15,19,10,14,14,0.5,5,0.071429,1,0.071429,1,36047023200,11204
232,2009,3,9,15,12,15,15,-0.25,-3,-0.4,-6,-0.4,-6,36047023200,11204
232,2009,4,13,9,12,15,15,0.083333,1,-0.133333,-2,-0.133333,-2,36047023200,11204
232,2009,5,8,13,13,24,24,-0.384615,-5,-0.666667,-16,-0.666667,-16,36047023200,11204
232,2010,0,19,19,20,21,21,-0.05,-1,-0.095238,-2,-0.095238,-2,36047023200,11204
232,2010,1,21,19,19,14,14,0.105263,2,0.5,7,0.5,7,36047023200,11204
232,2010,2,21,21,15,10,10,0.4,6,1.1,11,1.1,11,36047023200,11204
232,2010,3,17,21,9,12,12,0.888889,8,0.416667,5,0.416667,5,36047023200,11204
232,2010,4,10,17,13,12,12,-0.230769,-3,-0.166667,-2,-0.166667,-2,36047023200,11204
232,2010,5,14,10,8,14,14,0.75,6,0,0,0,0,36047023200,11204
234,2001,0,2,2,2,2,2,0,0,0,0,0,0,36047023400,11204
234,2001,1,3,2,3,3,3,0,0,0,0,0,0,36047023400,11204
234,2001,2,4,3,4,4,4,0,0,0,0,0,0,36047023400,11204
234,2001,3,4,4,4,4,4,0,0,0,0,0,0,36047023400,11204
234,2001,4,5,4,5,5,5,0,0,0,0,0,0,36047023400,11204
234,2001,5,4,5,4,4,4,0,0,0,0,0,0,36047023400,11204
234,2002,0,5,5,2,5,5,1.5,3,0,0,0,0,36047023400,11204
234,2002,1,5,5,3,5,5,0.666667,2,0,0,0,0,36047023400,11204
234,2002,2,1,5,4,1,1,-0.75,-3,0,0,0,0,36047023400,11204
234,2002,3,4,1,4,4,4,0,0,0,0,0,0,36047023400,11204
234,2002,4,4,4,5,4,4,-0.2,-1,0,0,0,0,36047023400,11204
234,2002,5,5,4,4,5,5,0.25,1,0,0,0,0,36047023400,11204
234,2003,0,3,3,5,3,3,-0.4,-2,0,0,0,0,36047023400,11204
234,2003,1,4,3,5,4,4,-0.2,-1,0,0,0,0,36047023400,11204
234,2003,2,5,4,1,5,5,4,4,0,0,0,0,36047023400,11204
234,2003,3,3,5,4,3,3,-0.25,-1,0,0,0,0,36047023400,11204
234,2003,4,4,3,4,4,4,0,0,0,0,0,0,36047023400,11204
234,2003,5,4,4,5,4,4,-0.2,-1,0,0,0,0,36047023400,11204
234,2004,0,2,2,3,2,2,-0.333333,-1,0,0,0,0,36047023400,11204
234,2004,1,3,2,4,3,3,-0.25,-1,0,0,0,0,36047023400,11204
234,2004,2,1,3,5,4,4,-0.8,-4,-0.75,-3,-0.75,-3,36047023400,11204
234,2004,3,6,1,3,4,4,1,3,0.5,2,0.5,2,36047023400,11204
234,2004,4,1,6,4,5,5,-0.75,-3,-0.8,-4,-0.8,-4,36047023400,11204
234,2004,5,3,1,4,4,4,-0.25,-1,-0.25,-1,-0.25,-1,36047023400,11204
234,2005,0,4,4,2,5,5,1,2,-0.2,-1,-0.2,-1,36047023400,11204
234,2005,1,1,4,3,5,5,-0.666667,-2,-0.8,-4,-0.8,-4,36047023400,11204
234,2005,2,3,1,1,1,1,2,2,2,2,2,2,36047023400,11204
234,2005,3,3,3,6,4,4,-0.5,-3,-0.25,-1,-0.25,-1,36047023400,11204
234,2005,4,6,3,1,4,4,5,5,0.5,2,0.5,2,36047023400,11204
234,2005,5,1,6,3,5,5,-0.666667,-2,-0.8,-4,-0.8,-4,36047023400,11204
234,2006,0,1,1,4,3,3,-0.75,-3,-0.666667,-2,-0.666667,-2,36047023400,11204
234,2006,1,1,1,1,4,4,0,0,-0.75,-3,-0.75,-3,36047023400,11204
234,2006,2,1,1,3,5,5,-0.666667,-2,-0.8,-4,-0.8,-4,36047023400,11204
234,2006,3,3,1,3,3,3,0,0,0,0,0,0,36047023400,11204
234,2006,4,2,3,6,4,4,-0.666667,-4,-0.5,-2,-0.5,-2,36047023400,11204
234,2006,5,7,2,1,4,4,6,6,0.75,3,0.75,3,36047023400,11204
234,2007,0,1,1,1,2,2,0,0,-0.5,-1,-0.5,-1,36047023400,11204
234,2007,1,2,1,1,3,3,1,1,-0.333333,-1,-0.333333,-1,36047023400,11204
234,2007,3,1,0,3,6,6,-0.666667,-2,-0.833333,-5,-0.833333,-5,36047023400,11204
234,2007,4,4,1,2,1,1,1,2,3,3,3,3,36047023400,11204
234,2007,5,3,4,7,3,3,-0.571429,-4,0,0,0,0,36047023400,11204
234,2008,0,3,3,1,4,4,2,2,-0.25,-1,-0.25,-1,36047023400,11204
234,2008,1,2,3,2,1,1,0,0,1,1,1,1,36047023400,11204
234,2008,2,2,2,3,3,3,-0.333333,-1,-0.333333,-1,-0.333333,-1,36047023400,11204
234,2008,3,2,2,1,3,3,1,1,-0.333333,-1,-0.333333,-1,36047023400,11204
234,2008,4,2,2,4,6,6,-0.5,-2,-0.666667,-4,-0.666667,-4,36047023400,11204
234,2008,5,5,2,3,1,1,0.666667,2,4,4,4,4,36047023400,11204
234,2009,0,3,3,3,1,1,0,0,2,2,2,2,36047023400,11204
234,2009,1,7,3,2,1,1,2.5,5,6,6,6,6,36047023400,11204
234,2009,2,1,7,2,1,1,-0.5,-1,0,0,0,0,36047023400,11204
234,2009,3,1,1,2,3,3,-0.5,-1,-0.666667,-2,-0.666667,-2,36047023400,11204
234,2009,4,2,1,2,2,2,0,0,0,0,0,0,36047023400,11204
234,2009,5,3,2,5,7,7,-0.4,-2,-0.571429,-4,-0.571429,-4,36047023400,11204
234,2010,0,4,4,3,1,1,0.333333,1,3,3,3,3,36047023400,11204
234,2010,1,5,4,7,2,2,-0.285714,-2,1.5,3,1.5,3,36047023400,11204
234,2010,2,8,5,1,0,0,7,7,1,8,1,8,36047023400,11204
234,2010,3,1,8,1,1,1,0,0,0,0,0,0,36047023400,11204
234,2010,4,3,1,2,4,4,0.5,1,-0.25,-1,-0.25,-1,36047023400,11204
234,2010,5,1,3,3,3,3,-0.666667,-2,-0.666667,-2,-0.666667,-2,36047023400,11204
236,2001,0,5,5,5,5,5,0,0,0,0,0,0,36047023600,11204
236,2001,1,4,5,4,4,4,0,0,0,0,0,0,36047023600,11204
236,2001,2,8,4,8,8,8,0,0,0,0,0,0,36047023600,11204
236,2001,3,9,8,9,9,9,0,0,0,0,0,0,36047023600,11204
236,2001,4,7,9,7,7,7,0,0,0,0,0,0,36047023600,11204
236,2001,5,6,7,6,6,6,0,0,0,0,0,0,36047023600,11204
236,2002,0,4,4,5,4,4,-0.2,-1,0,0,0,0,36047023600,11204
236,2002,1,7,4,4,7,7,0.75,3,0,0,0,0,36047023600,11204
236,2002,2,4,7,8,4,4,-0.5,-4,0,0,0,0,36047023600,11204
236,2002,3,7,4,9,7,7,-0.222222,-2,0,0,0,0,36047023600,11204
236,2002,4,6,7,7,6,6,-0.142857,-1,0,0,0,0,36047023600,11204
236,2002,5,10,6,6,10,10,0.666667,4,0,0,0,0,36047023600,11204
236,2003,0,10,10,4,10,10,1.5,6,0,0,0,0,36047023600,11204
236,2003,1,3,10,7,3,3,-0.571429,-4,0,0,0,0,36047023600,11204
236,2003,2,7,3,4,7,7,0.75,3,0,0,0,0,36047023600,11204
236,2003,3,6,7,7,6,6,-0.142857,-1,0,0,0,0,36047023600,11204
236,2003,4,6,6,6,6,6,0,0,0,0,0,0,36047023600,11204
236,2003,5,6,6,10,6,6,-0.4,-4,0,0,0,0,36047023600,11204
236,2004,0,6,6,10,5,5,-0.4,-4,0.2,1,0.2,1,36047023600,11204
236,2004,1,12,6,3,4,4,3,9,2,8,2,8,36047023600,11204
236,2004,2,3,12,7,8,8,-0.571429,-4,-0.625,-5,-0.625,-5,36047023600,11204
236,2004,3,2,3,6,9,9,-0.666667,-4,-0.777778,-7,-0.777778,-7,36047023600,11204
236,2004,4,4,2,6,7,7,-0.333333,-2,-0.428571,-3,-0.428571,-3,36047023600,11204
236,2004,5,6,4,6,6,6,0,0,0,0,0,0,36047023600,11204
236,2005,0,6,6,6,4,4,0,0,0.5,2,0.5,2,36047023600,11204
236,2005,1,5,6,12,7,7,-0.583333,-7,-0.285714,-2,-0.285714,-2,36047023600,11204
236,2005,2,12,5,3,4,4,3,9,2,8,2,8,36047023600,11204
236,2005,3,3,12,2,7,7,0.5,1,-0.571429,-4,-0.571429,-4,36047023600,11204
236,2005,4,2,3,4,6,6,-0.5,-2,-0.666667,-4,-0.666667,-4,36047023600,11204
236,2005,5,6,2,6,10,10,0,0,-0.4,-4,-0.4,-4,36047023600,11204
236,2006,0,3,3,6,10,10,-0.5,-3,-0.7,-7,-0.7,-7,36047023600,11204
236,2006,1,5,3,5,3,3,0,0,0.666667,2,0.666667,2,36047023600,11204
236,2006,2,4,5,12,7,7,-0.666667,-8,-0.428571,-3,-0.428571,-3,36047023600,11204
236,2006,3,9,4,3,6,6,2,6,0.5,3,0.5,3,36047023600,11204
236,2006,4,2,9,2,6,6,0,0,-0.666667,-4,-0.666667,-4,36047023600,11204
236,2006,5,3,2,6,6,6,-0.5,-3,-0.5,-3,-0.5,-3,36047023600,11204
236,2007,0,2,2,3,6,6,-0.333333,-1,-0.666667,-4,-0.666667,-4,36047023600,11204
236,2007,1,1,2,5,12,12,-0.8,-4,-0.916667,-11,-0.916667,-11,36047023600,11204
236,2007,2,5,1,4,3,3,0.25,1,0.666667,2,0.666667,2,36047023600,11204
236,2007,3,2,5,9,2,2,-0.777778,-7,0,0,0,0,36047023600,11204
236,2007,4,6,2,2,4,4,2,4,0.5,2,0.5,2,36047023600,11204
236,2007,5,2,6,3,6,6,-0.333333,-1,-0.666667,-4,-0.666667,-4,36047023600,11204
236,2008,0,9,9,2,6,6,3.5,7,0.5,3,0.5,3,36047023600,11204
236,2008,1,2,9,1,5,5,1,1,-0.6,-3,-0.6,-3,36047023600,11204
236,2008,2,1,2,5,12,12,-0.8,-4,-0.916667,-11,-0.916667,-11,36047023600,11204
236,2008,3,5,1,2,3,3,1.5,3,0.666667,2,0.666667,2,36047023600,11204
236,2008,4,4,5,6,2,2,-0.333333,-2,1,2,1,2,36047023600,11204
236,2008,5,5,4,2,6,6,1.5,3,-0.166667,-1,-0.166667,-1,36047023600,11204
236,2009,0,3,3,9,3,3,-0.666667,-6,0,0,0,0,36047023600,11204
236,2009,1,11,3,2,5,5,4.5,9,1.2,6,1.2,6,36047023600,11204
236,2009,2,3,11,1,4,4,2,2,-0.25,-1,-0.25,-1,36047023600,11204
236,2009,4,4,0,4,2,2,0,0,1,2,1,2,36047023600,11204
236,2009,5,3,4,5,3,3,-0.4,-2,0,0,0,0,36047023600,11204
236,2010,0,12,12,3,2,2,3,9,5,10,5,10,36047023600,11204
236,2010,1,3,12,11,1,1,-0.727273,-8,2,2,2,2,36047023600,11204
236,2010,2,8,3,3,5,5,1.666667,5,0.6,3,0.6,3,36047023600,11204
236,2010,3,5,8,2,2,2,1.5,3,1.5,3,1.5,3,36047023600,11204
236,2010,4,2,5,4,6,6,-0.5,-2,-0.666667,-4,-0.666667,-4,36047023600,11204
236,2010,5,3,2,3,2,2,0,0,0.5,1,0.5,1,36047023600,11204
238,2001,0,1,1,1,1,1,0,0,0,0,0,0,36047023800,11204
238,2001,1,7,1,7,7,7,0,0,0,0,0,0,36047023800,11204
238,2001,2,6,7,6,6,6,0,0,0,0,0,0,36047023800,11204
238,2001,3,3,6,3,3,3,0,0,0,0,0,0,36047023800,11204
238,2001,4,5,3,5,5,5,0,0,0,0,0,0,36047023800,11204
238,2001,5,2,5,2,2,2,0,0,0,0,0,0,36047023800,11204
238,2002,0,4,4,1,4,4,3,3,0,0,0,0,36047023800,11204
238,2002,1,2,4,7,2,2,-0.714286,-5,0,0,0,0,36047023800,11204
238,2002,2,7,2,6,7,7,0.166667,1,0,0,0,0,36047023800,11204
238,2002,3,6,7,3,6,6,1,3,0,0,0,0,36047023800,11204
238,2002,4,3,6,5,3,3,-0.4,-2,0,0,0,0,36047023800,11204
238,2002,5,5,3,2,5,5,1.5,3,0,0,0,0,36047023800,11204
238,2003,0,6,6,4,6,6,0.5,2,0,0,0,0,36047023800,11204
238,2003,1,4,6,2,4,4,1,2,0,0,0,0,36047023800,11204
238,2003,2,1,4,7,1,1,-0.857143,-6,0,0,0,0,36047023800,11204
238,2003,3,5,1,6,5,5,-0.166667,-1,0,0,0,0,36047023800,11204
238,2003,4,5,5,3,5,5,0.666667,2,0,0,0,0,36047023800,11204
238,2003,5,3,5,5,3,3,-0.4,-2,0,0,0,0,36047023800,11204
238,2004,0,4,4,6,1,1,-0.333333,-2,3,3,3,3,36047023800,11204
238,2004,1,5,4,4,7,7,0.25,1,-0.285714,-2,-0.285714,-2,36047023800,11204
238,2004,2,3,5,1,6,6,2,2,-0.5,-3,-0.5,-3,36047023800,11204
238,2004,3,2,3,5,3,3,-0.6,-3,-0.333333,-1,-0.333333,-1,36047023800,11204
238,2004,4,4,2,5,5,5,-0.2,-1,-0.2,-1,-0.2,-1,36047023800,11204
238,2004,5,5,4,3,2,2,0.666667,2,1.5,3,1.5,3,36047023800,11204
238,2005,0,2,2,4,4,4,-0.5,-2,-0.5,-2,-0.5,-2,36047023800,11204
238,2005,1,3,2,5,2,2,-0.4,-2,0.5,1,0.5,1,36047023800,11204
238,2005,2,2,3,3,7,7,-0.333333,-1,-0.714286,-5,-0.714286,-5,36047023800,11204
238,2005,3,1,2,2,6,6,-0.5,-1,-0.833333,-5,-0.833333,-5,36047023800,11204
238,2005,4,1,1,4,3,3,-0.75,-3,-0.666667,-2,-0.666667,-2,36047023800,11204
238,2005,5,4,1,5,5,5,-0.2,-1,-0.2,-1,-0.2,-1,36047023800,11204
238,2006,1,2,0,3,4,4,-0.333333,-1,-0.5,-2,-0.5,-2,36047023800,11204
238,2006,2,2,2,2,1,1,0,0,1,1,1,1,36047023800,11204
238,2006,3,1,2,1,5,5,0,0,-0.8,-4,-0.8,-4,36047023800,11204
238,2007,0,1,1,4,4,4,-0.75,-3,-0.75,-3,-0.75,-3,36047023800,11204
238,2007,2,3,0,2,3,3,0.5,1,0,0,0,0,36047023800,11204
238,2007,3,3,3,1,2,2,2,2,0.5,1,0.5,1,36047023800,11204
238,2007,4,1,3,4,4,4,-0.75,-3,-0.75,-3,-0.75,-3,36047023800,11204
238,2008,0,8,8,1,2,2,7,7,3,6,3,6,36047023800,11204
238,2008,4,2,0,1,1,1,1,1,1,1,1,1,36047023800,11204
238,2008,5,1,2,4,4,4,-0.75,-3,-0.75,-3,-0.75,-3,36047023800,11204
238,2009,0,5,5,8,0,0,-0.375,-3,1,5,1,5,36047023800,11204
238,2009,1,11,5,2,2,2,4.5,9,4.5,9,4.5,9,36047023800,11204
238,2009,2,1,11,2,2,2,-0.5,-1,-0.5,-1,-0.5,-1,36047023800,11204
238,2009,4,1,0,2,0,0,-0.5,-1,1,1,1,1,36047023800,11204
238,2010,0,6,6,5,1,1,0.2,1,5,5,5,5,36047023800,11204
238,2010,1,4,6,11,0,0,-0.636364,-7,1,4,1,4,36047023800,11204
238,2010,2,11,4,1,3,3,10,10,2.666667,8,2.666667,8,36047023800,11204
238,2010,3,1,11,3,3,3,-0.666667,-2,-0.666667,-2,-0.666667,-2,36047023800,11204
238,2010,5,1,0,0,0,0,1,1,1,1,1,1,36047023800,11204
240,2001,0,4,4,4,4,4,0,0,0,0,0,0,36047024000,11204
240,2001,1,8,4,8,8,8,0,0,0,0,0,0,36047024000,11204
240,2001,2,7,8,7,7,7,0,0,0,0,0,0,36047024000,11204
240,2001,3,3,7,3,3,3,0,0,0,0,0,0,36047024000,11204
240,2001,4,4,3,4,4,4,0,0,0,0,0,0,36047024000,11204
240,2001,5,6,4,6,6,6,0,0,0,0,0,0,36047024000,11204
240,2002,0,4,4,4,4,4,0,0,0,0,0,0,36047024000,11204
240,2002,1,4,4,8,4,4,-0.5,-4,0,0,0,0,36047024000,11204
240,2002,2,7,4,7,7,7,0,0,0,0,0,0,36047024000,11204
240,2002,3,6,7,3,6,6,1,3,0,0,0,0,36047024000,11204
240,2002,4,4,6,4,4,4,0,0,0,0,0,0,36047024000,11204
240,2002,5,5,4,6,5,5,-0.166667,-1,0,0,0,0,36047024000,11204
240,2003,0,2,2,4,2,2,-0.5,-2,0,0,0,0,36047024000,11204
240,2003,1,3,2,4,3,3,-0.25,-1,0,0,0,0,36047024000,11204
240,2003,2,2,3,7,2,2,-0.714286,-5,0,0,0,0,36047024000,11204
240,2003,3,7,2,6,7,7,0.166667,1,0,0,0,0,36047024000,11204
240,2003,4,5,7,4,5,5,0.25,1,0,0,0,0,36047024000,11204
240,2003,5,6,5,5,6,6,0.2,1,0,0,0,0,36047024000,11204
240,2004,0,2,2,2,4,4,0,0,-0.5,-2,-0.5,-2,36047024000,11204
240,2004,1,2,2,3,8,8,-0.333333,-1,-0.75,-6,-0.75,-6,36047024000,11204
240,2004,2,2,2,2,7,7,0,0,-0.714286,-5,-0.714286,-5,36047024000,11204
240,2004,3,2,2,7,3,3,-0.714286,-5,-0.333333,-1,-0.333333,-1,36047024000,11204
240,2004,4,8,2,5,4,4,0.6,3,1,4,1,4,36047024000,11204
240,2004,5,5,8,6,6,6,-0.166667,-1,-0.166667,-1,-0.166667,-1,36047024000,11204
240,2005,0,3,3,2,4,4,0.5,1,-0.25,-1,-0.25,-1,36047024000,11204
240,2005,1,2,3,2,4,4,0,0,-0.5,-2,-0.5,-2,36047024000,11204
240,2005,2,2,2,2,7,7,0,0,-0.714286,-5,-0.714286,-5,36047024000,11204
240,2005,3,3,2,2,6,6,0.5,1,-0.5,-3,-0.5,-3,36047024000,11204
240,2005,4,1,3,8,4,4,-0.875,-7,-0.75,-3,-0.75,-3,36047024000,11204
240,2005,5,7,1,5,5,5,0.4,2,0.4,2,0.4,2,36047024000,11204
240,2006,0,4,4,3,2,2,0.333333,1,1,2,1,2,36047024000,11204
240,2006,1,4,4,2,3,3,1,2,0.333333,1,0.333333,1,36047024000,11204
240,2006,2,2,4,2,2,2,0,0,0,0,0,0,36047024000,11204
240,2006,3,4,2,3,7,7,0.333333,1,-0.428571,-3,-0.428571,-3,36047024000,11204
240,2006,4,3,4,1,5,5,2,2,-0.4,-2,-0.4,-2,36047024000,11204
240,2006,5,2,3,7,6,6,-0.714286,-5,-0.666667,-4,-0.666667,-4,36047024000,11204
240,2007,0,5,5,4,2,2,0.25,1,1.5,3,1.5,3,36047024000,11204
240,2007,1,4,5,4,2,2,0,0,1,2,1,2,36047024000,11204
240,2007,2,2,4,2,2,2,0,0,0,0,0,0,36047024000,11204
240,2007,3,2,2,4,2,2,-0.5,-2,0,0,0,0,36047024000,11204
240,2007,4,4,2,3,8,8,0.333333,1,-0.5,-4,-0.5,-4,36047024000,11204
240,2007,5,2,4,2,5,5,0,0,-0.6,-3,-0.6,-3,36047024000,11204
240,2008,0,7,7,5,3,3,0.4,2,1.333333,4,1.333333,4,36047024000,11204
240,2008,1,3,7,4,2,2,-0.25,-1,0.5,1,0.5,1,36047024000,11204
240,2008,2,3,3,2,2,2,0.5,1,0.5,1,0.5,1,36047024000,11204
240,2008,3,2,3,2,3,3,0,0,-0.333333,-1,-0.333333,-1,36047024000,11204
240,2008,4,4,2,4,1,1,0,0,3,3,3,3,36047024000,11204
240,2008,5,4,4,2,7,7,1,2,-0.428571,-3,-0.428571,-3,36047024000,11204
240,2009,0,7,7,7,4,4,0,0,0.75,3,0.75,3,36047024000,11204
240,2009,1,10,7,3,4,4,2.333333,7,1.5,6,1.5,6,36047024000,11204
240,2009,2,4,10,3,2,2,0.333333,1,1,2,1,2,36047024000,11204
240,2009,3,3,4,2,4,4,0.5,1,-0.25,-1,-0.25,-1,36047024000,11204
240,2009,4,5,3,4,3,3,0.25,1,0.666667,2,0.666667,2,36047024000,11204
240,2009,5,5,5,4,2,2,0.25,1,1.5,3,1.5,3,36047024000,11204
240,2010,0,11,11,7,5,5,0.571429,4,1.2,6,1.2,6,36047024000,11204
240,2010,1,7,11,10,4,4,-0.3,-3,0.75,3,0.75,3,36047024000,11204
240,2010,2,10,7,4,2,2,1.5,6,4,8,4,8,36047024000,11204
240,2010,3,4,10,3,2,2,0.333333,1,1,2,1,2,36047024000,11204
240,2010,4,3,4,5,4,4,-0.4,-2,-0.25,-1,-0.25,-1,36047024000,11204
240,2010,5,3,3,5,2,2,-0.4,-2,0.5,1,0.5,1,36047024000,11204
242,2001,0,7,7,7,7,7,0,0,0,0,0,0,36047024200,11204
242,2001,1,11,7,11,11,11,0,0,0,0,0,0,36047024200,11204
242,2001,2,6,11,6,6,6,0,0,0,0,0,0,36047024200,11204
242,2001,3,8,6,8,8,8,0,0,0,0,0,0,36047024200,11204
242,2001,4,6,8,6,6,6,0,0,0,0,0,0,36047024200,11204
242,2001,5,6,6,6,6,6,0,0,0,0,0,0,36047024200,11204
242,2002,0,6,6,7,6,6,-0.142857,-1,0,0,0,0,36047024200,11204
242,2002,1,7,6,11,7,7,-0.363636,-4,0,0,0,0,36047024200,11204
242,2002,2,9,7,6,9,9,0.5,3,0,0,0,0,36047024200,11204
242,2002,3,5,9,8,5,5,-0.375,-3,0,0,0,0,36047024200,11204
242,2002,4,7,5,6,7,7,0.166667,1,0,0,0,0,36047024200,11204
242,2002,5,9,7,6,9,9,0.5,3,0,0,0,0,36047024200,11204
242,2003,0,5,5,6,5,5,-0.166667,-1,0,0,0,0,36047024200,11204
242,2003,1,7,5,7,7,7,0,0,0,0,0,0,36047024200,11204
242,2003,2,8,7,9,8,8,-0.111111,-1,0,0,0,0,36047024200,11204
242,2003,3,7,8,5,7,7,0.4,2,0,0,0,0,36047024200,11204
242,2003,4,4,7,7,4,4,-0.428571,-3,0,0,0,0,36047024200,11204
242,2003,5,6,4,9,6,6,-0.333333,-3,0,0,0,0,36047024200,11204
242,2004,0,5,5,5,7,7,0,0,-0.285714,-2,-0.285714,-2,36047024200,11204
242,2004,1,4,5,7,11,11,-0.428571,-3,-0.636364,-7,-0.636364,-7,36047024200,11204
242,2004,2,6,4,8,6,6,-0.25,-2,0,0,0,0,36047024200,11204
242,2004,3,4,6,7,8,8,-0.428571,-3,-0.5,-4,-0.5,-4,36047024200,11204
242,2004,4,6,4,4,6,6,0.5,2,0,0,0,0,36047024200,11204
242,2004,5,5,6,6,6,6,-0.166667,-1,-0.166667,-1,-0.166667,-1,36047024200,11204
242,2005,0,5,5,5,6,6,0,0,-0.166667,-1,-0.166667,-1,36047024200,11204
242,2005,1,7,5,4,7,7,0.75,3,0,0,0,0,36047024200,11204
242,2005,2,4,7,6,9,9,-0.333333,-2,-0.555556,-5,-0.555556,-5,36047024200,11204
242,2005,3,6,4,4,5,5,0.5,2,0.2,1,0.2,1,36047024200,11204
242,2005,4,6,6,6,7,7,0,0,-0.142857,-1,-0.142857,-1,36047024200,11204
242,2005,5,5,6,5,9,9,0,0,-0.444444,-4,-0.444444,-4,36047024200,11204
242,2006,0,9,9,5,5,5,0.8,4,0.8,4,0.8,4,36047024200,11204
242,2006,1,4,9,7,7,7,-0.428571,-3,-0.428571,-3,-0.428571,-3,36047024200,11204
242,2006,2,7,4,4,8,8,0.75,3,-0.125,-1,-0.125,-1,36047024200,11204
242,2006,3,2,7,6,7,7,-0.666667,-4,-0.714286,-5,-0.714286,-5,36047024200,11204
242,2006,4,6,2,6,4,4,0,0,0.5,2,0.5,2,36047024200,11204
242,2006,5,5,6,5,6,6,0,0,-0.166667,-1,-0.166667,-1,36047024200,11204
242,2007,0,6,6,9,5,5,-0.333333,-3,0.2,1,0.2,1,36047024200,11204
242,2007,1,6,6,4,4,4,0.5,2,0.5,2,0.5,2,36047024200,11204
242,2007,2,7,6,7,6,6,0,0,0.166667,1,0.166667,1,36047024200,11204
242,2007,3,5,7,2,4,4,1.5,3,0.25,1,0.25,1,36047024200,11204
242,2007,4,2,5,6,6,6,-0.666667,-4,-0.666667,-4,-0.666667,-4,36047024200,11204
242,2007,5,5,2,5,5,5,0,0,0,0,0,0,36047024200,11204
242,2008,0,3,3,6,5,5,-0.5,-3,-0.4,-2,-0.4,-2,36047024200,11204
242,2008,1,3,3,6,7,7,-0.5,-3,-0.571429,-4,-0.571429,-4,36047024200,11204
242,2008,2,2,3,7,4,4,-0.714286,-5,-0.5,-2,-0.5,-2,36047024200,11204
242,2008,3,5,2,5,6,6,0,0,-0.166667,-1,-0.166667,-1,36047024200,11204
242,2008,4,4,5,2,6,6,1,2,-0.333333,-2,-0.333333,-2,36047024200,11204
242,2008,5,2,4,5,5,5,-0.6,-3,-0.6,-3,-0.6,-3,36047024200,11204
242,2009,0,4,4,3,9,9,0.333333,1,-0.555556,-5,-0.555556,-5,36047024200,11204
242,2009,1,4,4,3,4,4,0.333333,1,0,0,0,0,36047024200,11204
242,2009,2,2,4,2,7,7,0,0,-0.714286,-5,-0.714286,-5,36047024200,11204
242,2009,3,3,2,5,2,2,-0.4,-2,0.5,1,0.5,1,36047024200,11204
242,2009,4,4,3,4,6,6,0,0,-0.333333,-2,-0.333333,-2,36047024200,11204
242,2009,5,3,4,2,5,5,0.5,1,-0.4,-2,-0.4,-2,36047024200,11204
242,2010,0,12,12,4,6,6,2,8,1,6,1,6,36047024200,11204
242,2010,1,2,12,4,6,6,-0.5,-2,-0.666667,-4,-0.666667,-4,36047024200,11204
242,2010,2,4,2,2,7,7,1,2,-0.428571,-3,-0.428571,-3,36047024200,11204
242,2010,3,2,4,3,5,5,-0.333333,-1,-0.6,-3,-0.6,-3,36047024200,11204
242,2010,4,3,2,4,2,2,-0.25,-1,0.5,1,0.5,1,36047024200,11204
242,2010,5,4,3,3,5,5,0.333333,1,-0.2,-1,-0.2,-1,36047024200,11204
244,2001,0,14,14,14,14,14,0,0,0,0,0,0,36047024400,11204
244,2001,1,21,14,21,21,21,0,0,0,0,0,0,36047024400,11204
244,2001,2,18,21,18,18,18,0,0,0,0,0,0,36047024400,11204
244,2001,3,29,18,29,29,29,0,0,0,0,0,0,36047024400,11204
244,2001,4,19,29,19,19,19,0,0,0,0,0,0,36047024400,11204
244,2001,5,15,19,15,15,15,0,0,0,0,0,0,36047024400,11204
244,2002,0,19,19,14,19,19,0.357143,5,0,0,0,0,36047024400,11204
244,2002,1,15,19,21,15,15,-0.285714,-6,0,0,0,0,36047024400,11204
244,2002,2,19,15,18,19,19,0.055556,1,0,0,0,0,36047024400,11204
244,2002,3,22,19,29,22,22,-0.241379,-7,0,0,0,0,36047024400,11204
244,2002,4,28,22,19,28,28,0.473684,9,0,0,0,0,36047024400,11204
244,2002,5,23,28,15,23,23,0.533333,8,0,0,0,0,36047024400,11204
244,2003,0,18,18,19,18,18,-0.052632,-1,0,0,0,0,36047024400,11204
244,2003,1,20,18,15,20,20,0.333333,5,0,0,0,0,36047024400,11204
244,2003,2,15,20,19,15,15,-0.210526,-4,0,0,0,0,36047024400,11204
244,2003,3,18,15,22,18,18,-0.181818,-4,0,0,0,0,36047024400,11204
244,2003,4,23,18,28,23,23,-0.178571,-5,0,0,0,0,36047024400,11204
244,2003,5,28,23,23,28,28,0.217391,5,0,0,0,0,36047024400,11204
244,2004,0,17,17,18,14,14,-0.055556,-1,0.214286,3,0.214286,3,36047024400,11204
244,2004,1,19,17,20,21,21,-0.05,-1,-0.095238,-2,-0.095238,-2,36047024400,11204
244,2004,2,14,19,15,18,18,-0.066667,-1,-0.222222,-4,-0.222222,-4,36047024400,11204
244,2004,3,13,14,18,29,29,-0.277778,-5,-0.551724,-16,-0.551724,-16,36047024400,11204
244,2004,4,16,13,23,19,19,-0.304348,-7,-0.157895,-3,-0.157895,-3,36047024400,11204
244,2004,5,19,16,28,15,15,-0.321429,-9,0.266667,4,0.266667,4,36047024400,11204
244,2005,0,20,20,17,19,19,0.176471,3,0.052632,1,0.052632,1,36047024400,11204
244,2005,1,20,20,19,15,15,0.052632,1,0.333333,5,0.333333,5,36047024400,11204
244,2005,2,22,20,14,19,19,0.571429,8,0.157895,3,0.157895,3,36047024400,11204
244,2005,3,9,22,13,22,22,-0.307692,-4,-0.590909,-13,-0.590909,-13,36047024400,11204
244,2005,4,15,9,16,28,28,-0.0625,-1,-0.464286,-13,-0.464286,-13,36047024400,11204
244,2005,5,14,15,19,23,23,-0.263158,-5,-0.391304,-9,-0.391304,-9,36047024400,11204
244,2006,0,12,12,20,18,18,-0.4,-8,-0.333333,-6,-0.333333,-6,36047024400,11204
244,2006,1,21,12,20,20,20,0.05,1,0.05,1,0.05,1,36047024400,11204
244,2006,2,19,21,22,15,15,-0.136364,-3,0.266667,4,0.266667,4,36047024400,11204
244,2006,3,23,19,9,18,18,1.555556,14,0.277778,5,0.277778,5,36047024400,11204
244,2006,4,10,23,15,23,23,-0.333333,-5,-0.565217,-13,-0.565217,-13,36047024400,11204
244,2006,5,14,10,14,28,28,0,0,-0.5,-14,-0.5,-14,36047024400,11204
244,2007,0,10,10,12,17,17,-0.166667,-2,-0.411765,-7,-0.411765,-7,36047024400,11204
244,2007,1,13,10,21,19,19,-0.380952,-8,-0.315789,-6,-0.315789,-6,36047024400,11204
244,2007,2,19,13,19,14,14,0,0,0.357143,5,0.357143,5,36047024400,11204
244,2007,3,21,19,23,13,13,-0.086957,-2,0.615385,8,0.615385,8,36047024400,11204
244,2007,4,18,21,10,16,16,0.8,8,0.125,2,0.125,2,36047024400,11204
244,2007,5,12,18,14,19,19,-0.142857,-2,-0.368421,-7,-0.368421,-7,36047024400,11204
244,2008,0,14,14,10,20,20,0.4,4,-0.3,-6,-0.3,-6,36047024400,11204
244,2008,1,8,14,13,20,20,-0.384615,-5,-0.6,-12,-0.6,-12,36047024400,11204
244,2008,2,17,8,19,22,22,-0.105263,-2,-0.227273,-5,-0.227273,-5,36047024400,11204
244,2008,3,14,17,21,9,9,-0.333333,-7,0.555556,5,0.555556,5,36047024400,11204
244,2008,4,23,14,18,15,15,0.277778,5,0.533333,8,0.533333,8,36047024400,11204
244,2008,5,19,23,12,14,14,0.583333,7,0.357143,5,0.357143,5,36047024400,11204
244,2009,0,13,13,14,12,12,-0.071429,-1,0.083333,1,0.083333,1,36047024400,11204
244,2009,1,18,13,8,21,21,1.25,10,-0.142857,-3,-0.142857,-3,36047024400,11204
244,2009,2,13,18,17,19,19,-0.235294,-4,-0.315789,-6,-0.315789,-6,36047024400,11204
244,2009,3,14,13,14,23,23,0,0,-0.391304,-9,-0.391304,-9,36047024400,11204
244,2009,4,16,14,23,10,10,-0.304348,-7,0.6,6,0.6,6,36047024400,11204
244,2009,5,27,16,19,14,14,0.421053,8,0.928571,13,0.928571,13,36047024400,11204
244,2010,0,19,19,13,10,10,0.461538,6,0.9,9,0.9,9,36047024400,11204
244,2010,1,13,19,18,13,13,-0.277778,-5,0,0,0,0,36047024400,11204
244,2010,2,17,13,13,19,19,0.307692,4,-0.105263,-2,-0.105263,-2,36047024400,11204
244,2010,3,17,17,14,21,21,0.214286,3,-0.190476,-4,-0.190476,-4,36047024400,11204
244,2010,4,13,17,16,18,18,-0.1875,-3,-0.277778,-5,-0.277778,-5,36047024400,11204
244,2010,5,15,13,27,12,12,-0.444444,-12,0.25,3,0.25,3,36047024400,11204
246,2001,0,1,1,1,1,1,0,0,0,0,0,0,36047024600,11204
246,2001,1,3,1,3,3,3,0,0,0,0,0,0,36047024600,11204
246,2001,2,2,3,2,2,2,0,0,0,0,0,0,36047024600,11204
246,2001,3,4,2,4,4,4,0,0,0,0,0,0,36047024600,11204
246,2001,4,1,4,1,1,1,0,0,0,0,0,0,36047024600,11204
246,2001,5,6,1,6,6,6,0,0,0,0,0,0,36047024600,11204
246,2002,0,5,5,1,5,5,4,4,0,0,0,0,36047024600,11204
246,2002,1,2,5,3,2,2,-0.333333,-1,0,0,0,0,36047024600,11204
246,2002,2,5,2,2,5,5,1.5,3,0,0,0,0,36047024600,11204
246,2002,3,6,5,4,6,6,0.5,2,0,0,0,0,36047024600,11204
246,2002,4,3,6,1,3,3,2,2,0,0,0,0,36047024600,11204
246,2002,5,1,3,6,1,1,-0.833333,-5,0,0,0,0,36047024600,11204
246,2003,0,4,4,5,4,4,-0.2,-1,0,0,0,0,36047024600,11204
246,2003,1,4,4,2,4,4,1,2,0,0,0,0,36047024600,11204
246,2003,2,3,4,5,3,3,-0.4,-2,0,0,0,0,36047024600,11204
246,2003,3,4,3,6,4,4,-0.333333,-2,0,0,0,0,36047024600,11204
246,2003,4,7,4,3,7,7,1.333333,4,0,0,0,0,36047024600,11204
246,2003,5,2,7,1,2,2,1,1,0,0,0,0,36047024600,11204
246,2004,0,3,3,4,1,1,-0.25,-1,2,2,2,2,36047024600,11204
246,2004,1,4,3,4,3,3,0,0,0.333333,1,0.333333,1,36047024600,11204
246,2004,2,4,4,3,2,2,0.333333,1,1,2,1,2,36047024600,11204
246,2004,3,2,4,4,4,4,-0.5,-2,-0.5,-2,-0.5,-2,36047024600,11204
246,2004,4,5,2,7,1,1,-0.285714,-2,4,4,4,4,36047024600,11204
246,2004,5,8,5,2,6,6,3,6,0.333333,2,0.333333,2,36047024600,11204
246,2005,0,3,3,3,5,5,0,0,-0.4,-2,-0.4,-2,36047024600,11204
246,2005,1,1,3,4,2,2,-0.75,-3,-0.5,-1,-0.5,-1,36047024600,11204
246,2005,2,4,1,4,5,5,0,0,-0.2,-1,-0.2,-1,36047024600,11204
246,2005,3,3,4,2,6,6,0.5,1,-0.5,-3,-0.5,-3,36047024600,11204
246,2005,4,2,3,5,3,3,-0.6,-3,-0.333333,-1,-0.333333,-1,36047024600,11204
246,2005,5,5,2,8,1,1,-0.375,-3,4,4,4,4,36047024600,11204
246,2006,0,8,8,3,4,4,1.666667,5,1,4,1,4,36047024600,11204
246,2006,1,5,8,1,4,4,4,4,0.25,1,0.25,1,36047024600,11204
246,2006,2,2,5,4,3,3,-0.5,-2,-0.333333,-1,-0.333333,-1,36047024600,11204
246,2006,3,5,2,3,4,4,0.666667,2,0.25,1,0.25,1,36047024600,11204
246,2006,4,4,5,2,7,7,1,2,-0.428571,-3,-0.428571,-3,36047024600,11204
246,2006,5,2,4,5,2,2,-0.6,-3,0,0,0,0,36047024600,11204
246,2007,0,4,4,8,3,3,-0.5,-4,0.333333,1,0.333333,1,36047024600,11204
246,2007,1,8,4,5,4,4,0.6,3,1,4,1,4,36047024600,11204
246,2007,2,3,8,2,4,4,0.5,1,-0.25,-1,-0.25,-1,36047024600,11204
246,2007,3,3,3,5,2,2,-0.4,-2,0.5,1,0.5,1,36047024600,11204
246,2007,4,5,3,4,5,5,0.25,1,0,0,0,0,36047024600,11204
246,2007,5,3,5,2,8,8,0.5,1,-0.625,-5,-0.625,-5,36047024600,11204
246,2008,0,5,5,4,3,3,0.25,1,0.666667,2,0.666667,2,36047024600,11204
246,2008,1,6,5,8,1,1,-0.25,-2,5,5,5,5,36047024600,11204
246,2008,2,9,6,3,4,4,2,6,1.25,5,1.25,5,36047024600,11204
246,2008,3,2,9,3,3,3,-0.333333,-1,-0.333333,-1,-0.333333,-1,36047024600,11204
246,2008,4,2,2,5,2,2,-0.6,-3,0,0,0,0,36047024600,11204
246,2008,5,4,2,3,5,5,0.333333,1,-0.2,-1,-0.2,-1,36047024600,11204
246,2009,0,3,3,5,8,8,-0.4,-2,-0.625,-5,-0.625,-5,36047024600,11204
246,2009,1,7,3,6,5,5,0.166667,1,0.4,2,0.4,2,36047024600,11204
246,2009,2,6,7,9,2,2,-0.333333,-3,2,4,2,4,36047024600,11204
246,2009,3,8,6,2,5,5,3,6,0.6,3,0.6,3,36047024600,11204
246,2009,4,3,8,2,4,4,0.5,1,-0.25,-1,-0.25,-1,36047024600,11204
246,2009,5,1,3,4,2,2,-0.75,-3,-0.5,-1,-0.5,-1,36047024600,11204
246,2010,0,3,3,3,4,4,0,0,-0.25,-1,-0.25,-1,36047024600,11204
246,2010,1,4,3,7,8,8,-0.428571,-3,-0.5,-4,-0.5,-4,36047024600,11204
246,2010,2,7,4,6,3,3,0.166667,1,1.333333,4,1.333333,4,36047024600,11204
246,2010,3,7,7,8,3,3,-0.125,-1,1.333333,4,1.333333,4,36047024600,11204
246,2010,4,8,7,3,5,5,1.666667,5,0.6,3,0.6,3,36047024600,11204
246,2010,5,5,8,1,3,3,4,4,0.666667,2,0.666667,2,36047024600,11204
248,2001,0,16,16,16,16,16,0,0,0,0,0,0,36047024800,11204
248,2001,1,33,16,33,33,33,0,0,0,0,0,0,36047024800,11204
248,2001,2,20,33,20,20,20,0,0,0,0,0,0,36047024800,11204
248,2001,3,15,20,15,15,15,0,0,0,0,0,0,36047024800,11204
248,2001,4,27,15,27,27,27,0,0,0,0,0,0,36047024800,11204
248,2001,5,29,27,29,29,29,0,0,0,0,0,0,36047024800,11204
248,2002,0,21,21,16,21,21,0.3125,5,0,0,0,0,36047024800,11204
248,2002,1,20,21,33,20,20,-0.393939,-13,0,0,0,0,36047024800,11204
248,2002,2,35,20,20,35,35,0.75,15,0,0,0,0,36047024800,11204
248,2002,3,17,35,15,17,17,0.133333,2,0,0,0,0,36047024800,11204
248,2002,4,18,17,27,18,18,-0.333333,-9,0,0,0,0,36047024800,11204
248,2002,5,24,18,29,24,24,-0.172414,-5,0,0,0,0,36047024800,11204
248,2003,0,25,25,21,25,25,0.190476,4,0,0,0,0,36047024800,11204
248,2003,1,21,25,20,21,21,0.05,1,0,0,0,0,36047024800,11204
248,2003,2,22,21,35,22,22,-0.371429,-13,0,0,0,0,36047024800,11204
248,2003,3,32,22,17,32,32,0.882353,15,0,0,0,0,36047024800,11204
248,2003,4,21,32,18,21,21,0.166667,3,0,0,0,0,36047024800,11204
248,2003,5,23,21,24,23,23,-0.041667,-1,0,0,0,0,36047024800,11204
248,2004,0,26,26,25,16,16,0.04,1,0.625,10,0.625,10,36047024800,11204
248,2004,1,22,26,21,33,33,0.047619,1,-0.333333,-11,-0.333333,-11,36047024800,11204
248,2004,2,21,22,22,20,20,-0.045455,-1,0.05,1,0.05,1,36047024800,11204
248,2004,3,20,21,32,15,15,-0.375,-12,0.333333,5,0.333333,5,36047024800,11204
248,2004,4,31,20,21,27,27,0.47619,10,0.148148,4,0.148148,4,36047024800,11204
248,2004,5,19,31,23,29,29,-0.173913,-4,-0.344828,-10,-0.344828,-10,36047024800,11204
248,2005,0,25,25,26,21,21,-0.038462,-1,0.190476,4,0.190476,4,36047024800,11204
248,2005,1,27,25,22,20,20,0.227273,5,0.35,7,0.35,7,36047024800,11204
248,2005,2,22,27,21,35,35,0.047619,1,-0.371429,-13,-0.371429,-13,36047024800,11204
248,2005,3,19,22,20,17,17,-0.05,-1,0.117647,2,0.117647,2,36047024800,11204
248,2005,4,18,19,31,18,18,-0.419355,-13,0,0,0,0,36047024800,11204
248,2005,5,30,18,19,24,24,0.578947,11,0.25,6,0.25,6,36047024800,11204
248,2006,0,19,19,25,25,25,-0.24,-6,-0.24,-6,-0.24,-6,36047024800,11204
248,2006,1,20,19,27,21,21,-0.259259,-7,-0.047619,-1,-0.047619,-1,36047024800,11204
248,2006,2,23,20,22,22,22,0.045455,1,0.045455,1,0.045455,1,36047024800,11204
248,2006,3,19,23,19,32,32,0,0,-0.40625,-13,-0.40625,-13,36047024800,11204
248,2006,4,16,19,18,21,21,-0.111111,-2,-0.238095,-5,-0.238095,-5,36047024800,11204
248,2006,5,17,16,30,23,23,-0.433333,-13,-0.26087,-6,-0.26087,-6,36047024800,11204
248,2007,0,12,12,19,26,26,-0.368421,-7,-0.538462,-14,-0.538462,-14,36047024800,11204
248,2007,1,22,12,20,22,22,0.1,2,0,0,0,0,36047024800,11204
248,2007,2,22,22,23,21,21,-0.043478,-1,0.047619,1,0.047619,1,36047024800,11204
248,2007,3,23,22,19,20,20,0.210526,4,0.15,3,0.15,3,36047024800,11204
248,2007,4,20,23,16,31,31,0.25,4,-0.354839,-11,-0.354839,-11,36047024800,11204
248,2007,5,16,20,17,19,19,-0.058824,-1,-0.157895,-3,-0.157895,-3,36047024800,11204
248,2008,0,23,23,12,25,25,0.916667,11,-0.08,-2,-0.08,-2,36047024800,11204
248,2008,1,15,23,22,27,27,-0.318182,-7,-0.444444,-12,-0.444444,-12,36047024800,11204
248,2008,2,26,15,22,22,22,0.181818,4,0.181818,4,0.181818,4,36047024800,11204
248,2008,3,17,26,23,19,19,-0.26087,-6,-0.105263,-2,-0.105263,-2,36047024800,11204
248,2008,4,19,17,20,18,18,-0.05,-1,0.055556,1,0.055556,1,36047024800,11204
248,2008,5,20,19,16,30,30,0.25,4,-0.333333,-10,-0.333333,-10,36047024800,11204
248,2009,0,21,21,23,19,19,-0.086957,-2,0.105263,2,0.105263,2,36047024800,11204
248,2009,1,29,21,15,20,20,0.933333,14,0.45,9,0.45,9,36047024800,11204
248,2009,2,11,29,26,23,23,-0.576923,-15,-0.521739,-12,-0.521739,-12,36047024800,11204
248,2009,3,25,11,17,19,19,0.470588,8,0.315789,6,0.315789,6,36047024800,11204
248,2009,4,19,25,19,16,16,0,0,0.1875,3,0.1875,3,36047024800,11204
248,2009,5,16,19,20,17,17,-0.2,-4,-0.058824,-1,-0.058824,-1,36047024800,11204
248,2010,0,24,24,21,12,12,0.142857,3,1,12,1,12,36047024800,11204
248,2010,1,24,24,29,22,22,-0.172414,-5,0.090909,2,0.090909,2,36047024800,11204
248,2010,2,22,24,11,22,22,1,11,0,0,0,0,36047024800,11204
248,2010,3,10,22,25,23,23,-0.6,-15,-0.565217,-13,-0.565217,-13,36047024800,11204
248,2010,4,23,10,19,20,20,0.210526,4,0.15,3,0.15,3,36047024800,11204
248,2010,5,19,23,16,16,16,0.1875,3,0.1875,3,0.1875,3,36047024800,11204
250,2001,0,10,10,10,10,10,0,0,0,0,0,0,36047025000,11204
250,2001,1,18,10,18,18,18,0,0,0,0,0,0,36047025000,11204
250,2001,2,11,18,11,11,11,0,0,0,0,0,0,36047025000,11204
250,2001,3,16,11,16,16,16,0,0,0,0,0,0,36047025000,11204
250,2001,4,15,16,15,15,15,0,0,0,0,0,0,36047025000,11204
250,2001,5,16,15,16,16,16,0,0,0,0,0,0,36047025000,11204
250,2002,0,11,11,10,11,11,0.1,1,0,0,0,0,36047025000,11204
250,2002,1,11,11,18,11,11,-0.388889,-7,0,0,0,0,36047025000,11204
250,2002,2,15,11,11,15,15,0.363636,4,0,0,0,0,36047025000,11204
250,2002,3,12,15,16,12,12,-0.25,-4,0,0,0,0,36047025000,11204
250,2002,4,19,12,15,19,19,0.266667,4,0,0,0,0,36047025000,11204
250,2002,5,13,19,16,13,13,-0.1875,-3,0,0,0,0,36047025000,11204
250,2003,0,13,13,11,13,13,0.181818,2,0,0,0,0,36047025000,11204
250,2003,1,10,13,11,10,10,-0.090909,-1,0,0,0,0,36047025000,11204
250,2003,2,12,10,15,12,12,-0.2,-3,0,0,0,0,36047025000,11204
250,2003,3,17,12,12,17,17,0.416667,5,0,0,0,0,36047025000,11204
250,2003,4,14,17,19,14,14,-0.263158,-5,0,0,0,0,36047025000,11204
250,2003,5,20,14,13,20,20,0.538462,7,0,0,0,0,36047025000,11204
250,2004,0,17,17,13,10,10,0.307692,4,0.7,7,0.7,7,36047025000,11204
250,2004,1,16,17,10,18,18,0.6,6,-0.111111,-2,-0.111111,-2,36047025000,11204
250,2004,2,9,16,12,11,11,-0.25,-3,-0.181818,-2,-0.181818,-2,36047025000,11204
250,2004,3,10,9,17,16,16,-0.411765,-7,-0.375,-6,-0.375,-6,36047025000,11204
250,2004,4,14,10,14,15,15,0,0,-0.066667,-1,-0.066667,-1,36047025000,11204
250,2004,5,13,14,20,16,16,-0.35,-7,-0.1875,-3,-0.1875,-3,36047025000,11204
250,2005,0,12,12,17,11,11,-0.294118,-5,0.090909,1,0.090909,1,36047025000,11204
250,2005,1,18,12,16,11,11,0.125,2,0.636364,7,0.636364,7,36047025000,11204
250,2005,2,16,18,9,15,15,0.777778,7,0.066667,1,0.066667,1,36047025000,11204
250,2005,3,12,16,10,12,12,0.2,2,0,0,0,0,36047025000,11204
250,2005,4,9,12,14,19,19,-0.357143,-5,-0.526316,-10,-0.526316,-10,36047025000,11204
250,2005,5,15,9,13,13,13,0.153846,2,0.153846,2,0.153846,2,36047025000,11204
250,2006,0,14,14,12,13,13,0.166667,2,0.076923,1,0.076923,1,36047025000,11204
250,2006,1,14,14,18,10,10,-0.222222,-4,0.4,4,0.4,4,36047025000,11204
250,2006,2,19,14,16,12,12,0.1875,3,0.583333,7,0.583333,7,36047025000,11204
250,2006,3,15,19,12,17,17,0.25,3,-0.117647,-2,-0.117647,-2,36047025000,11204
250,2006,4,10,15,9,14,14,0.111111,1,-0.285714,-4,-0.285714,-4,36047025000,11204
250,2006,5,9,10,15,20,20,-0.4,-6,-0.55,-11,-0.55,-11,36047025000,11204
250,2007,0,13,13,14,17,17,-0.071429,-1,-0.235294,-4,-0.235294,-4,36047025000,11204
250,2007,1,15,13,14,16,16,0.071429,1,-0.0625,-1,-0.0625,-1,36047025000,11204
250,2007,2,15,15,19,9,9,-0.210526,-4,0.666667,6,0.666667,6,36047025000,11204
250,2007,3,18,15,15,10,10,0.2,3,0.8,8,0.8,8,36047025000,11204
250,2007,4,15,18,10,14,14,0.5,5,0.071429,1,0.071429,1,36047025000,11204
250,2007,5,10,15,9,13,13,0.111111,1,-0.230769,-3,-0.230769,-3,36047025000,11204
250,2008,0,8,8,13,12,12,-0.384615,-5,-0.333333,-4,-0.333333,-4,36047025000,11204
250,2008,1,13,8,15,18,18,-0.133333,-2,-0.277778,-5,-0.277778,-5,36047025000,11204
250,2008,2,14,13,15,16,16,-0.066667,-1,-0.125,-2,-0.125,-2,36047025000,11204
250,2008,3,13,14,18,12,12,-0.277778,-5,0.083333,1,0.083333,1,36047025000,11204
250,2008,4,16,13,15,9,9,0.066667,1,0.777778,7,0.777778,7,36047025000,11204
250,2008,5,14,16,10,15,15,0.4,4,-0.066667,-1,-0.066667,-1,36047025000,11204
250,2009,0,21,21,8,14,14,1.625,13,0.5,7,0.5,7,36047025000,11204
250,2009,1,11,21,13,14,14,-0.153846,-2,-0.214286,-3,-0.214286,-3,36047025000,11204
250,2009,2,12,11,14,19,19,-0.142857,-2,-0.368421,-7,-0.368421,-7,36047025000,11204
250,2009,3,16,12,13,15,15,0.230769,3,0.066667,1,0.066667,1,36047025000,11204
250,2009,4,14,16,16,10,10,-0.125,-2,0.4,4,0.4,4,36047025000,11204
250,2009,5,19,14,14,9,9,0.357143,5,1.111111,10,1.111111,10,36047025000,11204
250,2010,0,16,16,21,13,13,-0.238095,-5,0.230769,3,0.230769,3,36047025000,11204
250,2010,1,15,16,11,15,15,0.363636,4,0,0,0,0,36047025000,11204
250,2010,2,11,15,12,15,15,-0.083333,-1,-0.266667,-4,-0.266667,-4,36047025000,11204
250,2010,3,12,11,16,18,18,-0.25,-4,-0.333333,-6,-0.333333,-6,36047025000,11204
250,2010,4,17,12,14,15,15,0.214286,3,0.133333,2,0.133333,2,36047025000,11204
250,2010,5,16,17,19,10,10,-0.157895,-3,0.6,6,0.6,6,36047025000,11204
252,2001,0,31,31,31,31,31,0,0,0,0,0,0,36047025200,11204
252,2001,1,48,31,48,48,48,0,0,0,0,0,0,36047025200,11204
252,2001,2,45,48,45,45,45,0,0,0,0,0,0,36047025200,11204
252,2001,3,47,45,47,47,47,0,0,0,0,0,0,36047025200,11204
252,2001,4,33,47,33,33,33,0,0,0,0,0,0,36047025200,11204
252,2001,5,37,33,37,37,37,0,0,0,0,0,0,36047025200,11204
252,2002,0,32,32,31,32,32,0.032258,1,0,0,0,0,36047025200,11204
252,2002,1,37,32,48,37,37,-0.229167,-11,0,0,0,0,36047025200,11204
252,2002,2,48,37,45,48,48,0.066667,3,0,0,0,0,36047025200,11204
252,2002,3,43,48,47,43,43,-0.085106,-4,0,0,0,0,36047025200,11204
252,2002,4,45,43,33,45,45,0.363636,12,0,0,0,0,36047025200,11204
252,2002,5,33,45,37,33,33,-0.108108,-4,0,0,0,0,36047025200,11204
252,2003,0,36,36,32,36,36,0.125,4,0,0,0,0,36047025200,11204
252,2003,1,41,36,37,41,41,0.108108,4,0,0,0,0,36047025200,11204
252,2003,2,38,41,48,38,38,-0.208333,-10,0,0,0,0,36047025200,11204
252,2003,3,51,38,43,51,51,0.186047,8,0,0,0,0,36047025200,11204
252,2003,4,42,51,45,42,42,-0.066667,-3,0,0,0,0,36047025200,11204
252,2003,5,43,42,33,43,43,0.30303,10,0,0,0,0,36047025200,11204
252,2004,0,47,47,36,31,31,0.305556,11,0.516129,16,0.516129,16,36047025200,11204
252,2004,1,44,47,41,48,48,0.073171,3,-0.083333,-4,-0.083333,-4,36047025200,11204
252,2004,2,35,44,38,45,45,-0.078947,-3,-0.222222,-10,-0.222222,-10,36047025200,11204
252,2004,3,35,35,51,47,47,-0.313725,-16,-0.255319,-12,-0.255319,-12,36047025200,11204
252,2004,4,50,35,42,33,33,0.190476,8,0.515152,17,0.515152,17,36047025200,11204
252,2004,5,38,50,43,37,37,-0.116279,-5,0.027027,1,0.027027,1,36047025200,11204
252,2005,0,43,43,47,32,32,-0.085106,-4,0.34375,11,0.34375,11,36047025200,11204
252,2005,1,47,43,44,37,37,0.068182,3,0.27027,10,0.27027,10,36047025200,11204
252,2005,2,42,47,35,48,48,0.2,7,-0.125,-6,-0.125,-6,36047025200,11204
252,2005,3,29,42,35,43,43,-0.171429,-6,-0.325581,-14,-0.325581,-14,36047025200,11204
252,2005,4,33,29,50,45,45,-0.34,-17,-0.266667,-12,-0.266667,-12,36047025200,11204
252,2005,5,50,33,38,33,33,0.315789,12,0.515152,17,0.515152,17,36047025200,11204
252,2006,0,30,30,43,36,36,-0.302326,-13,-0.166667,-6,-0.166667,-6,36047025200,11204
252,2006,1,48,30,47,41,41,0.021277,1,0.170732,7,0.170732,7,36047025200,11204
252,2006,2,41,48,42,38,38,-0.02381,-1,0.078947,3,0.078947,3,36047025200,11204
252,2006,3,35,41,29,51,51,0.206897,6,-0.313725,-16,-0.313725,-16,36047025200,11204
252,2006,4,29,35,33,42,42,-0.121212,-4,-0.309524,-13,-0.309524,-13,36047025200,11204
252,2006,5,33,29,50,43,43,-0.34,-17,-0.232558,-10,-0.232558,-10,36047025200,11204
252,2007,0,28,28,30,47,47,-0.066667,-2,-0.404255,-19,-0.404255,-19,36047025200,11204
252,2007,1,33,28,48,44,44,-0.3125,-15,-0.25,-11,-0.25,-11,36047025200,11204
252,2007,2,46,33,41,35,35,0.121951,5,0.314286,11,0.314286,11,36047025200,11204
252,2007,3,37,46,35,35,35,0.057143,2,0.057143,2,0.057143,2,36047025200,11204
252,2007,4,29,37,29,50,50,0,0,-0.42,-21,-0.42,-21,36047025200,11204
252,2007,5,29,29,33,38,38,-0.121212,-4,-0.236842,-9,-0.236842,-9,36047025200,11204
252,2008,0,40,40,28,43,43,0.428571,12,-0.069767,-3,-0.069767,-3,36047025200,11204
252,2008,1,33,40,33,47,47,0,0,-0.297872,-14,-0.297872,-14,36047025200,11204
252,2008,2,33,33,46,42,42,-0.282609,-13,-0.214286,-9,-0.214286,-9,36047025200,11204
252,2008,3,46,33,37,29,29,0.243243,9,0.586207,17,0.586207,17,36047025200,11204
252,2008,4,40,46,29,33,33,0.37931,11,0.212121,7,0.212121,7,36047025200,11204
252,2008,5,28,40,29,50,50,-0.034483,-1,-0.44,-22,-0.44,-22,36047025200,11204
252,2009,0,40,40,40,30,30,0,0,0.333333,10,0.333333,10,36047025200,11204
252,2009,1,46,40,33,48,48,0.393939,13,-0.041667,-2,-0.041667,-2,36047025200,11204
252,2009,2,33,46,33,41,41,0,0,-0.195122,-8,-0.195122,-8,36047025200,11204
252,2009,3,36,33,46,35,35,-0.217391,-10,0.028571,1,0.028571,1,36047025200,11204
252,2009,4,47,36,40,29,29,0.175,7,0.62069,18,0.62069,18,36047025200,11204
252,2009,5,43,47,28,33,33,0.535714,15,0.30303,10,0.30303,10,36047025200,11204
252,2010,0,48,48,40,28,28,0.2,8,0.714286,20,0.714286,20,36047025200,11204
252,2010,1,44,48,46,33,33,-0.043478,-2,0.333333,11,0.333333,11,36047025200,11204
252,2010,2,50,44,33,46,46,0.515152,17,0.086957,4,0.086957,4,36047025200,11204
252,2010,3,33,50,36,37,37,-0.083333,-3,-0.108108,-4,-0.108108,-4,36047025200,11204
252,2010,4,40,33,47,29,29,-0.148936,-7,0.37931,11,0.37931,11,36047025200,11204
252,2010,5,48,40,43,29,29,0.116279,5,0.655172,19,0.655172,19,36047025200,11204
254,2001,0,28,28,28,28,28,0,0,0,0,0,0,36047025400,11204
254,2001,1,37,28,37,37,37,0,0,0,0,0,0,36047025400,11204
254,2001,2,33,37,33,33,33,0,0,0,0,0,0,36047025400,11204
254,2001,3,30,33,30,30,30,0,0,0,0,0,0,36047025400,11204
254,2001,4,32,30,32,32,32,0,0,0,0,0,0,36047025400,11204
254,2001,5,34,32,34,34,34,0,0,0,0,0,0,36047025400,11204
254,2002,0,29,29,28,29,29,0.035714,1,0,0,0,0,36047025400,11204
254,2002,1,31,29,37,31,31,-0.162162,-6,0,0,0,0,36047025400,11204
254,2002,2,30,31,33,30,30,-0.090909,-3,0,0,0,0,36047025400,11204
254,2002,3,29,30,30,29,29,-0.033333,-1,0,0,0,0,36047025400,11204
254,2002,4,28,29,32,28,28,-0.125,-4,0,0,0,0,36047025400,11204
254,2002,5,33,28,34,33,33,-0.029412,-1,0,0,0,0,36047025400,11204
254,2003,0,28,28,29,28,28,-0.034483,-1,0,0,0,0,36047025400,11204
254,2003,1,31,28,31,31,31,0,0,0,0,0,0,36047025400,11204
254,2003,2,35,31,30,35,35,0.166667,5,0,0,0,0,36047025400,11204
254,2003,3,26,35,29,26,26,-0.103448,-3,0,0,0,0,36047025400,11204
254,2003,4,40,26,28,40,40,0.428571,12,0,0,0,0,36047025400,11204
254,2003,5,26,40,33,26,26,-0.212121,-7,0,0,0,0,36047025400,11204
254,2004,0,36,36,28,28,28,0.285714,8,0.285714,8,0.285714,8,36047025400,11204
254,2004,1,32,36,31,37,37,0.032258,1,-0.135135,-5,-0.135135,-5,36047025400,11204
254,2004,2,29,32,35,33,33,-0.171429,-6,-0.121212,-4,-0.121212,-4,36047025400,11204
254,2004,3,39,29,26,30,30,0.5,13,0.3,9,0.3,9,36047025400,11204
254,2004,4,23,39,40,32,32,-0.425,-17,-0.28125,-9,-0.28125,-9,36047025400,11204
254,2004,5,39,23,26,34,34,0.5,13,0.147059,5,0.147059,5,36047025400,11204
254,2005,0,21,21,36,29,29,-0.416667,-15,-0.275862,-8,-0.275862,-8,36047025400,11204
254,2005,1,33,21,32,31,31,0.03125,1,0.064516,2,0.064516,2,36047025400,11204
254,2005,2,30,33,29,30,30,0.034483,1,0,0,0,0,36047025400,11204
254,2005,3,24,30,39,29,29,-0.384615,-15,-0.172414,-5,-0.172414,-5,36047025400,11204
254,2005,4,39,24,23,28,28,0.695652,16,0.392857,11,0.392857,11,36047025400,11204
254,2005,5,26,39,39,33,33,-0.333333,-13,-0.212121,-7,-0.212121,-7,36047025400,11204
254,2006,0,29,29,21,28,28,0.380952,8,0.035714,1,0.035714,1,36047025400,11204
254,2006,1,19,29,33,31,31,-0.424242,-14,-0.387097,-12,-0.387097,-12,36047025400,11204
254,2006,2,31,19,30,35,35,0.033333,1,-0.114286,-4,-0.114286,-4,36047025400,11204
254,2006,3,26,31,24,26,26,0.083333,2,0,0,0,0,36047025400,11204
254,2006,4,24,26,39,40,40,-0.384615,-15,-0.4,-16,-0.4,-16,36047025400,11204
254,2006,5,35,24,26,26,26,0.346154,9,0.346154,9,0.346154,9,36047025400,11204
254,2007,0,28,28,29,36,36,-0.034483,-1,-0.222222,-8,-0.222222,-8,36047025400,11204
254,2007,1,29,28,19,32,32,0.526316,10,-0.09375,-3,-0.09375,-3,36047025400,11204
254,2007,2,22,29,31,29,29,-0.290323,-9,-0.241379,-7,-0.241379,-7,36047025400,11204
254,2007,3,27,22,26,39,39,0.038462,1,-0.307692,-12,-0.307692,-12,36047025400,11204
254,2007,4,29,27,24,23,23,0.208333,5,0.26087,6,0.26087,6,36047025400,11204
254,2007,5,27,29,35,39,39,-0.228571,-8,-0.307692,-12,-0.307692,-12,36047025400,11204
254,2008,0,35,35,28,21,21,0.25,7,0.666667,14,0.666667,14,36047025400,11204
254,2008,1,27,35,29,33,33,-0.068966,-2,-0.181818,-6,-0.181818,-6,36047025400,11204
254,2008,2,31,27,22,30,30,0.409091,9,0.033333,1,0.033333,1,36047025400,11204
254,2008,3,25,31,27,24,24,-0.074074,-2,0.041667,1,0.041667,1,36047025400,11204
254,2008,4,30,25,29,39,39,0.034483,1,-0.230769,-9,-0.230769,-9,36047025400,11204
254,2008,5,33,30,27,26,26,0.222222,6,0.269231,7,0.269231,7,36047025400,11204
254,2009,0,17,17,35,29,29,-0.514286,-18,-0.413793,-12,-0.413793,-12,36047025400,11204
254,2009,1,39,17,27,19,19,0.444444,12,1.052632,20,1.052632,20,36047025400,11204
254,2009,2,30,39,31,31,31,-0.032258,-1,-0.032258,-1,-0.032258,-1,36047025400,11204
254,2009,3,30,30,25,26,26,0.2,5,0.153846,4,0.153846,4,36047025400,11204
254,2009,4,28,30,30,24,24,-0.066667,-2,0.166667,4,0.166667,4,36047025400,11204
254,2009,5,29,28,33,35,35,-0.121212,-4,-0.171429,-6,-0.171429,-6,36047025400,11204
254,2010,0,35,35,17,28,28,1.058824,18,0.25,7,0.25,7,36047025400,11204
254,2010,1,20,35,39,29,29,-0.487179,-19,-0.310345,-9,-0.310345,-9,36047025400,11204
254,2010,2,35,20,30,22,22,0.166667,5,0.590909,13,0.590909,13,36047025400,11204
254,2010,3,28,35,30,27,27,-0.066667,-2,0.037037,1,0.037037,1,36047025400,11204
254,2010,4,25,28,28,29,29,-0.107143,-3,-0.137931,-4,-0.137931,-4,36047025400,11204
254,2010,5,30,25,29,27,27,0.034483,1,0.111111,3,0.111111,3,36047025400,11204
256,2001,0,33,33,33,33,33,0,0,0,0,0,0,36047025600,11204
256,2001,1,26,33,26,26,26,0,0,0,0,0,0,36047025600,11204
256,2001,2,36,26,36,36,36,0,0,0,0,0,0,36047025600,11204
256,2001,3,21,36,21,21,21,0,0,0,0,0,0,36047025600,11204
256,2001,4,46,21,46,46,46,0,0,0,0,0,0,36047025600,11204
256,2001,5,22,46,22,22,22,0,0,0,0,0,0,36047025600,11204
256,2002,0,31,31,33,31,31,-0.060606,-2,0,0,0,0,36047025600,11204
256,2002,1,38,31,26,38,38,0.461538,12,0,0,0,0,36047025600,11204
256,2002,2,27,38,36,27,27,-0.25,-9,0,0,0,0,36047025600,11204
256,2002,3,34,27,21,34,34,0.619048,13,0,0,0,0,36047025600,11204
256,2002,4,22,34,46,22,22,-0.521739,-24,0,0,0,0,36047025600,11204
256,2002,5,43,22,22,43,43,0.954545,21,0,0,0,0,36047025600,11204
256,2003,0,30,30,31,30,30,-0.032258,-1,0,0,0,0,36047025600,11204
256,2003,1,35,30,38,35,35,-0.078947,-3,0,0,0,0,36047025600,11204
256,2003,2,39,35,27,39,39,0.444444,12,0,0,0,0,36047025600,11204
256,2003,3,29,39,34,29,29,-0.147059,-5,0,0,0,0,36047025600,11204
256,2003,4,31,29,22,31,31,0.409091,9,0,0,0,0,36047025600,11204
256,2003,5,25,31,43,25,25,-0.418605,-18,0,0,0,0,36047025600,11204
256,2004,0,37,37,30,33,33,0.233333,7,0.121212,4,0.121212,4,36047025600,11204
256,2004,1,28,37,35,26,26,-0.2,-7,0.076923,2,0.076923,2,36047025600,11204
256,2004,2,30,28,39,36,36,-0.230769,-9,-0.166667,-6,-0.166667,-6,36047025600,11204
256,2004,3,43,30,29,21,21,0.482759,14,1.047619,22,1.047619,22,36047025600,11204
256,2004,4,31,43,31,46,46,0,0,-0.326087,-15,-0.326087,-15,36047025600,11204
256,2004,5,27,31,25,22,22,0.08,2,0.227273,5,0.227273,5,36047025600,11204
256,2005,0,29,29,37,31,31,-0.216216,-8,-0.064516,-2,-0.064516,-2,36047025600,11204
256,2005,1,32,29,28,38,38,0.142857,4,-0.157895,-6,-0.157895,-6,36047025600,11204
256,2005,2,31,32,30,27,27,0.033333,1,0.148148,4,0.148148,4,36047025600,11204
256,2005,3,29,31,43,34,34,-0.325581,-14,-0.147059,-5,-0.147059,-5,36047025600,11204
256,2005,4,37,29,31,22,22,0.193548,6,0.681818,15,0.681818,15,36047025600,11204
256,2005,5,26,37,27,43,43,-0.037037,-1,-0.395349,-17,-0.395349,-17,36047025600,11204
256,2006,0,39,39,29,30,30,0.344828,10,0.3,9,0.3,9,36047025600,11204
256,2006,1,31,39,32,35,35,-0.03125,-1,-0.114286,-4,-0.114286,-4,36047025600,11204
256,2006,2,34,31,31,39,39,0.096774,3,-0.128205,-5,-0.128205,-5,36047025600,11204
256,2006,3,32,34,29,29,29,0.103448,3,0.103448,3,0.103448,3,36047025600,11204
256,2006,4,27,32,37,31,31,-0.27027,-10,-0.129032,-4,-0.129032,-4,36047025600,11204
256,2006,5,42,27,26,25,25,0.615385,16,0.68,17,0.68,17,36047025600,11204
256,2007,0,23,23,39,37,37,-0.410256,-16,-0.378378,-14,-0.378378,-14,36047025600,11204
256,2007,1,37,23,31,28,28,0.193548,6,0.321429,9,0.321429,9,36047025600,11204
256,2007,2,28,37,34,30,30,-0.176471,-6,-0.066667,-2,-0.066667,-2,36047025600,11204
256,2007,3,31,28,32,43,43,-0.03125,-1,-0.27907,-12,-0.27907,-12,36047025600,11204
256,2007,4,28,31,27,31,31,0.037037,1,-0.096774,-3,-0.096774,-3,36047025600,11204
256,2007,5,28,28,42,27,27,-0.333333,-14,0.037037,1,0.037037,1,36047025600,11204
256,2008,0,27,27,23,29,29,0.173913,4,-0.068966,-2,-0.068966,-2,36047025600,11204
256,2008,1,24,27,37,32,32,-0.351351,-13,-0.25,-8,-0.25,-8,36047025600,11204
256,2008,2,35,24,28,31,31,0.25,7,0.129032,4,0.129032,4,36047025600,11204
256,2008,3,29,35,31,29,29,-0.064516,-2,0,0,0,0,36047025600,11204
256,2008,4,29,29,28,37,37,0.035714,1,-0.216216,-8,-0.216216,-8,36047025600,11204
256,2008,5,25,29,28,26,26,-0.107143,-3,-0.038462,-1,-0.038462,-1,36047025600,11204
256,2009,0,24,24,27,39,39,-0.111111,-3,-0.384615,-15,-0.384615,-15,36047025600,11204
256,2009,1,32,24,24,31,31,0.333333,8,0.032258,1,0.032258,1,36047025600,11204
256,2009,2,24,32,35,34,34,-0.314286,-11,-0.294118,-10,-0.294118,-10,36047025600,11204
256,2009,3,37,24,29,32,32,0.275862,8,0.15625,5,0.15625,5,36047025600,11204
256,2009,4,31,37,29,27,27,0.068966,2,0.148148,4,0.148148,4,36047025600,11204
256,2009,5,27,31,25,42,42,0.08,2,-0.357143,-15,-0.357143,-15,36047025600,11204
256,2010,0,40,40,24,23,23,0.666667,16,0.73913,17,0.73913,17,36047025600,11204
256,2010,1,27,40,32,37,37,-0.15625,-5,-0.27027,-10,-0.27027,-10,36047025600,11204
256,2010,2,32,27,24,28,28,0.333333,8,0.142857,4,0.142857,4,36047025600,11204
256,2010,3,23,32,37,31,31,-0.378378,-14,-0.258065,-8,-0.258065,-8,36047025600,11204
256,2010,4,37,23,31,28,28,0.193548,6,0.321429,9,0.321429,9,36047025600,11204
256,2010,5,23,37,27,28,28,-0.148148,-4,-0.178571,-5,-0.178571,-5,36047025600,11204
258,2001,0,53,53,53,53,53,0,0,0,0,0,0,36047025800,11204
258,2001,1,39,53,39,39,39,0,0,0,0,0,0,36047025800,11204
258,2001,2,43,39,43,43,43,0,0,0,0,0,0,36047025800,11204
258,2001,3,61,43,61,61,61,0,0,0,0,0,0,36047025800,11204
258,2001,4,35,61,35,35,35,0,0,0,0,0,0,36047025800,11204
258,2001,5,56,35,56,56,56,0,0,0,0,0,0,36047025800,11204
258,2002,0,47,47,53,47,47,-0.113208,-6,0,0,0,0,36047025800,11204
258,2002,1,48,47,39,48,48,0.230769,9,0,0,0,0,36047025800,11204
258,2002,2,43,48,43,43,43,0,0,0,0,0,0,36047025800,11204
258,2002,3,40,43,61,40,40,-0.344262,-21,0,0,0,0,36047025800,11204
258,2002,4,53,40,35,53,53,0.514286,18,0,0,0,0,36047025800,11204
258,2002,5,33,53,56,33,33,-0.410714,-23,0,0,0,0,36047025800,11204
258,2003,0,35,35,47,35,35,-0.255319,-12,0,0,0,0,36047025800,11204
258,2003,1,48,35,48,48,48,0,0,0,0,0,0,36047025800,11204
258,2003,2,51,48,43,51,51,0.186047,8,0,0,0,0,36047025800,11204
258,2003,3,42,51,40,42,42,0.05,2,0,0,0,0,36047025800,11204
258,2003,4,43,42,53,43,43,-0.188679,-10,0,0,0,0,36047025800,11204
258,2003,5,57,43,33,57,57,0.727273,24,0,0,0,0,36047025800,11204
258,2004,0,50,50,35,53,53,0.428571,15,-0.056604,-3,-0.056604,-3,36047025800,11204
258,2004,1,42,50,48,39,39,-0.125,-6,0.076923,3,0.076923,3,36047025800,11204
258,2004,2,51,42,51,43,43,0,0,0.186047,8,0.186047,8,36047025800,11204
258,2004,3,53,51,42,61,61,0.261905,11,-0.131148,-8,-0.131148,-8,36047025800,11204
258,2004,4,47,53,43,35,35,0.093023,4,0.342857,12,0.342857,12,36047025800,11204
258,2004,5,49,47,57,56,56,-0.140351,-8,-0.125,-7,-0.125,-7,36047025800,11204
258,2005,0,59,59,50,47,47,0.18,9,0.255319,12,0.255319,12,36047025800,11204
258,2005,1,45,59,42,48,48,0.071429,3,-0.0625,-3,-0.0625,-3,36047025800,11204
258,2005,2,46,45,51,43,43,-0.098039,-5,0.069767,3,0.069767,3,36047025800,11204
258,2005,3,54,46,53,40,40,0.018868,1,0.35,14,0.35,14,36047025800,11204
258,2005,4,54,54,47,53,53,0.148936,7,0.018868,1,0.018868,1,36047025800,11204
258,2005,5,48,54,49,33,33,-0.020408,-1,0.454545,15,0.454545,15,36047025800,11204
258,2006,0,51,51,59,35,35,-0.135593,-8,0.457143,16,0.457143,16,36047025800,11204
258,2006,1,54,51,45,48,48,0.2,9,0.125,6,0.125,6,36047025800,11204
258,2006,2,48,54,46,51,51,0.043478,2,-0.058824,-3,-0.058824,-3,36047025800,11204
258,2006,3,45,48,54,42,42,-0.166667,-9,0.071429,3,0.071429,3,36047025800,11204
258,2006,4,50,45,54,43,43,-0.074074,-4,0.162791,7,0.162791,7,36047025800,11204
258,2006,5,50,50,48,57,57,0.041667,2,-0.122807,-7,-0.122807,-7,36047025800,11204
258,2007,0,37,37,51,50,50,-0.27451,-14,-0.26,-13,-0.26,-13,36047025800,11204
258,2007,1,51,37,54,42,42,-0.055556,-3,0.214286,9,0.214286,9,36047025800,11204
258,2007,2,54,51,48,51,51,0.125,6,0.058824,3,0.058824,3,36047025800,11204
258,2007,3,53,54,45,53,53,0.177778,8,0,0,0,0,36047025800,11204
258,2007,4,48,53,50,47,47,-0.04,-2,0.021277,1,0.021277,1,36047025800,11204
258,2007,5,48,48,50,49,49,-0.04,-2,-0.020408,-1,-0.020408,-1,36047025800,11204
258,2008,0,50,50,37,59,59,0.351351,13,-0.152542,-9,-0.152542,-9,36047025800,11204
258,2008,1,43,50,51,45,45,-0.156863,-8,-0.044444,-2,-0.044444,-2,36047025800,11204
258,2008,2,52,43,54,46,46,-0.037037,-2,0.130435,6,0.130435,6,36047025800,11204
258,2008,3,54,52,53,54,54,0.018868,1,0,0,0,0,36047025800,11204
258,2008,4,63,54,48,54,54,0.3125,15,0.166667,9,0.166667,9,36047025800,11204
258,2008,5,51,63,48,48,48,0.0625,3,0.0625,3,0.0625,3,36047025800,11204
258,2009,0,59,59,50,51,51,0.18,9,0.156863,8,0.156863,8,36047025800,11204
258,2009,1,54,59,43,54,54,0.255814,11,0,0,0,0,36047025800,11204
258,2009,2,47,54,52,48,48,-0.096154,-5,-0.020833,-1,-0.020833,-1,36047025800,11204
258,2009,3,49,47,54,45,45,-0.092593,-5,0.088889,4,0.088889,4,36047025800,11204
258,2009,4,54,49,63,50,50,-0.142857,-9,0.08,4,0.08,4,36047025800,11204
258,2009,5,54,54,51,50,50,0.058824,3,0.08,4,0.08,4,36047025800,11204
258,2010,0,56,56,59,37,37,-0.050847,-3,0.513514,19,0.513514,19,36047025800,11204
258,2010,1,52,56,54,51,51,-0.037037,-2,0.019608,1,0.019608,1,36047025800,11204
258,2010,2,53,52,47,54,54,0.12766,6,-0.018519,-1,-0.018519,-1,36047025800,11204
258,2010,3,47,53,49,53,53,-0.040816,-2,-0.113208,-6,-0.113208,-6,36047025800,11204
258,2010,4,52,47,54,48,48,-0.037037,-2,0.083333,4,0.083333,4,36047025800,11204
258,2010,5,57,52,54,48,48,0.055556,3,0.1875,9,0.1875,9,36047025800,11204
260,2001,0,26,26,26,26,26,0,0,0,0,0,0,36047026000,11204
260,2001,1,31,26,31,31,31,0,0,0,0,0,0,36047026000,11204
260,2001,2,30,31,30,30,30,0,0,0,0,0,0,36047026000,11204
260,2001,3,23,30,23,23,23,0,0,0,0,0,0,36047026000,11204
260,2001,4,26,23,26,26,26,0,0,0,0,0,0,36047026000,11204
260,2001,5,21,26,21,21,21,0,0,0,0,0,0,36047026000,11204
260,2002,0,28,28,26,28,28,0.076923,2,0,0,0,0,36047026000,11204
260,2002,1,25,28,31,25,25,-0.193548,-6,0,0,0,0,36047026000,11204
260,2002,2,30,25,30,30,30,0,0,0,0,0,0,36047026000,11204
260,2002,3,30,30,23,30,30,0.304348,7,0,0,0,0,36047026000,11204
260,2002,4,25,30,26,25,25,-0.038462,-1,0,0,0,0,36047026000,11204
260,2002,5,26,25,21,26,26,0.238095,5,0,0,0,0,36047026000,11204
260,2003,0,27,27,28,27,27,-0.035714,-1,0,0,0,0,36047026000,11204
260,2003,1,29,27,25,29,29,0.16,4,0,0,0,0,36047026000,11204
260,2003,2,24,29,30,24,24,-0.2,-6,0,0,0,0,36047026000,11204
260,2003,3,30,24,30,30,30,0,0,0,0,0,0,36047026000,11204
260,2003,4,27,30,25,27,27,0.08,2,0,0,0,0,36047026000,11204
260,2003,5,29,27,26,29,29,0.115385,3,0,0,0,0,36047026000,11204
260,2004,0,24,24,27,26,26,-0.111111,-3,-0.076923,-2,-0.076923,-2,36047026000,11204
260,2004,1,26,24,29,31,31,-0.103448,-3,-0.16129,-5,-0.16129,-5,36047026000,11204
260,2004,2,27,26,24,30,30,0.125,3,-0.1,-3,-0.1,-3,36047026000,11204
260,2004,3,22,27,30,23,23,-0.266667,-8,-0.043478,-1,-0.043478,-1,36047026000,11204
260,2004,4,25,22,27,26,26,-0.074074,-2,-0.038462,-1,-0.038462,-1,36047026000,11204
260,2004,5,22,25,29,21,21,-0.241379,-7,0.047619,1,0.047619,1,36047026000,11204
260,2005,0,26,26,24,28,28,0.083333,2,-0.071429,-2,-0.071429,-2,36047026000,11204
260,2005,1,29,26,26,25,25,0.115385,3,0.16,4,0.16,4,36047026000,11204
260,2005,2,26,29,27,30,30,-0.037037,-1,-0.133333,-4,-0.133333,-4,36047026000,11204
260,2005,3,28,26,22,30,30,0.272727,6,-0.066667,-2,-0.066667,-2,36047026000,11204
260,2005,4,21,28,25,25,25,-0.16,-4,-0.16,-4,-0.16,-4,36047026000,11204
260,2005,5,23,21,22,26,26,0.045455,1,-0.115385,-3,-0.115385,-3,36047026000,11204
260,2006,0,28,28,26,27,27,0.076923,2,0.037037,1,0.037037,1,36047026000,11204
260,2006,1,25,28,29,29,29,-0.137931,-4,-0.137931,-4,-0.137931,-4,36047026000,11204
260,2006,2,33,25,26,24,24,0.269231,7,0.375,9,0.375,9,36047026000,11204
260,2006,3,32,33,28,30,30,0.142857,4,0.066667,2,0.066667,2,36047026000,11204
260,2006,4,29,32,21,27,27,0.380952,8,0.074074,2,0.074074,2,36047026000,11204
260,2006,5,22,29,23,29,29,-0.043478,-1,-0.241379,-7,-0.241379,-7,36047026000,11204
260,2007,0,33,33,28,24,24,0.178571,5,0.375,9,0.375,9,36047026000,11204
260,2007,1,26,33,25,26,26,0.04,1,0,0,0,0,36047026000,11204
260,2007,2,27,26,33,27,27,-0.181818,-6,0,0,0,0,36047026000,11204
260,2007,3,31,27,32,22,22,-0.03125,-1,0.409091,9,0.409091,9,36047026000,11204
260,2007,4,27,31,29,25,25,-0.068966,-2,0.08,2,0.08,2,36047026000,11204
260,2007,5,27,27,22,22,22,0.227273,5,0.227273,5,0.227273,5,36047026000,11204
260,2008,0,34,34,33,26,26,0.030303,1,0.307692,8,0.307692,8,36047026000,11204
260,2008,1,31,34,26,29,29,0.192308,5,0.068966,2,0.068966,2,36047026000,11204
260,2008,2,26,31,27,26,26,-0.037037,-1,0,0,0,0,36047026000,11204
260,2008,3,27,26,31,28,28,-0.129032,-4,-0.035714,-1,-0.035714,-1,36047026000,11204
260,2008,4,31,27,27,21,21,0.148148,4,0.47619,10,0.47619,10,36047026000,11204
260,2008,5,28,31,27,23,23,0.037037,1,0.217391,5,0.217391,5,36047026000,11204
260,2009,0,27,27,34,28,28,-0.205882,-7,-0.035714,-1,-0.035714,-1,36047026000,11204
260,2009,1,46,27,31,25,25,0.483871,15,0.84,21,0.84,21,36047026000,11204
260,2009,2,29,46,26,33,33,0.115385,3,-0.121212,-4,-0.121212,-4,36047026000,11204
260,2009,3,33,29,27,32,32,0.222222,6,0.03125,1,0.03125,1,36047026000,11204
260,2009,4,33,33,31,29,29,0.064516,2,0.137931,4,0.137931,4,36047026000,11204
260,2009,5,33,33,28,22,22,0.178571,5,0.5,11,0.5,11,36047026000,11204
260,2010,0,26,26,27,33,33,-0.037037,-1,-0.212121,-7,-0.212121,-7,36047026000,11204
260,2010,1,31,26,46,26,26,-0.326087,-15,0.192308,5,0.192308,5,36047026000,11204
260,2010,2,52,31,29,27,27,0.793103,23,0.925926,25,0.925926,25,36047026000,11204
260,2010,3,29,52,33,31,31,-0.121212,-4,-0.064516,-2,-0.064516,-2,36047026000,11204
260,2010,4,34,29,33,27,27,0.030303,1,0.259259,7,0.259259,7,36047026000,11204
260,2010,5,35,34,33,27,27,0.060606,2,0.296296,8,0.296296,8,36047026000,11204
262,2001,0,10,10,10,10,10,0,0,0,0,0,0,36047026200,11204
262,2001,1,20,10,20,20,20,0,0,0,0,0,0,36047026200,11204
262,2001,2,18,20,18,18,18,0,0,0,0,0,0,36047026200,11204
262,2001,3,16,18,16,16,16,0,0,0,0,0,0,36047026200,11204
262,2001,4,20,16,20,20,20,0,0,0,0,0,0,36047026200,11204
262,2001,5,15,20,15,15,15,0,0,0,0,0,0,36047026200,11204
262,2002,0,13,13,10,13,13,0.3,3,0,0,0,0,36047026200,11204
262,2002,1,9,13,20,9,9,-0.55,-11,0,0,0,0,36047026200,11204
262,2002,2,21,9,18,21,21,0.166667,3,0,0,0,0,36047026200,11204
262,2002,3,19,21,16,19,19,0.1875,3,0,0,0,0,36047026200,11204
262,2002,4,21,19,20,21,21,0.05,1,0,0,0,0,36047026200,11204
262,2002,5,22,21,15,22,22,0.466667,7,0,0,0,0,36047026200,11204
262,2003,0,12,12,13,12,12,-0.076923,-1,0,0,0,0,36047026200,11204
262,2003,1,12,12,9,12,12,0.333333,3,0,0,0,0,36047026200,11204
262,2003,2,10,12,21,10,10,-0.52381,-11,0,0,0,0,36047026200,11204
262,2003,3,22,10,19,22,22,0.157895,3,0,0,0,0,36047026200,11204
262,2003,4,16,22,21,16,16,-0.238095,-5,0,0,0,0,36047026200,11204
262,2003,5,18,16,22,18,18,-0.181818,-4,0,0,0,0,36047026200,11204
262,2004,0,12,12,12,10,10,0,0,0.2,2,0.2,2,36047026200,11204
262,2004,1,10,12,12,20,20,-0.166667,-2,-0.5,-10,-0.5,-10,36047026200,11204
262,2004,2,16,10,10,18,18,0.6,6,-0.111111,-2,-0.111111,-2,36047026200,11204
262,2004,3,11,16,22,16,16,-0.5,-11,-0.3125,-5,-0.3125,-5,36047026200,11204
262,2004,4,24,11,16,20,20,0.5,8,0.2,4,0.2,4,36047026200,11204
262,2004,5,20,24,18,15,15,0.111111,2,0.333333,5,0.333333,5,36047026200,11204
262,2005,0,13,13,12,13,13,0.083333,1,0,0,0,0,36047026200,11204
262,2005,1,10,13,10,9,9,0,0,0.111111,1,0.111111,1,36047026200,11204
262,2005,2,13,10,16,21,21,-0.1875,-3,-0.380952,-8,-0.380952,-8,36047026200,11204
262,2005,3,17,13,11,19,19,0.545455,6,-0.105263,-2,-0.105263,-2,36047026200,11204
262,2005,4,11,17,24,21,21,-0.541667,-13,-0.47619,-10,-0.47619,-10,36047026200,11204
262,2005,5,25,11,20,22,22,0.25,5,0.136364,3,0.136364,3,36047026200,11204
262,2006,0,22,22,13,12,12,0.692308,9,0.833333,10,0.833333,10,36047026200,11204
262,2006,1,14,22,10,12,12,0.4,4,0.166667,2,0.166667,2,36047026200,11204
262,2006,2,11,14,13,10,10,-0.153846,-2,0.1,1,0.1,1,36047026200,11204
262,2006,3,15,11,17,22,22,-0.117647,-2,-0.318182,-7,-0.318182,-7,36047026200,11204
262,2006,4,15,15,11,16,16,0.363636,4,-0.0625,-1,-0.0625,-1,36047026200,11204
262,2006,5,12,15,25,18,18,-0.52,-13,-0.333333,-6,-0.333333,-6,36047026200,11204
262,2007,0,16,16,22,12,12,-0.272727,-6,0.333333,4,0.333333,4,36047026200,11204
262,2007,1,22,16,14,10,10,0.571429,8,1.2,12,1.2,12,36047026200,11204
262,2007,2,14,22,11,16,16,0.272727,3,-0.125,-2,-0.125,-2,36047026200,11204
262,2007,3,8,14,15,11,11,-0.466667,-7,-0.272727,-3,-0.272727,-3,36047026200,11204
262,2007,4,12,8,15,24,24,-0.2,-3,-0.5,-12,-0.5,-12,36047026200,11204
262,2007,5,16,12,12,20,20,0.333333,4,-0.2,-4,-0.2,-4,36047026200,11204
262,2008,0,17,17,16,13,13,0.0625,1,0.307692,4,0.307692,4,36047026200,11204
262,2008,1,16,17,22,10,10,-0.272727,-6,0.6,6,0.6,6,36047026200,11204
262,2008,2,25,16,14,13,13,0.785714,11,0.923077,12,0.923077,12,36047026200,11204
262,2008,3,12,25,8,17,17,0.5,4,-0.294118,-5,-0.294118,-5,36047026200,11204
262,2008,4,8,12,12,11,11,-0.333333,-4,-0.272727,-3,-0.272727,-3,36047026200,11204
262,2008,5,15,8,16,25,25,-0.0625,-1,-0.4,-10,-0.4,-10,36047026200,11204
262,2009,0,17,17,17,22,22,0,0,-0.227273,-5,-0.227273,-5,36047026200,11204
262,2009,1,22,17,16,14,14,0.375,6,0.571429,8,0.571429,8,36047026200,11204
262,2009,2,20,22,25,11,11,-0.2,-5,0.818182,9,0.818182,9,36047026200,11204
262,2009,3,23,20,12,15,15,0.916667,11,0.533333,8,0.533333,8,36047026200,11204
262,2009,4,13,23,8,15,15,0.625,5,-0.133333,-2,-0.133333,-2,36047026200,11204
262,2009,5,12,13,15,12,12,-0.2,-3,0,0,0,0,36047026200,11204
262,2010,0,17,17,17,16,16,0,0,0.0625,1,0.0625,1,36047026200,11204
262,2010,1,18,17,22,22,22,-0.181818,-4,-0.181818,-4,-0.181818,-4,36047026200,11204
262,2010,2,21,18,20,14,14,0.05,1,0.5,7,0.5,7,36047026200,11204
262,2010,3,26,21,23,8,8,0.130435,3,2.25,18,2.25,18,36047026200,11204
262,2010,4,23,26,13,12,12,0.769231,10,0.916667,11,0.916667,11,36047026200,11204
262,2010,5,18,23,12,16,16,0.5,6,0.125,2,0.125,2,36047026200,11204
264,2001,0,32,32,32,32,32,0,0,0,0,0,0,36047026400,11204
264,2001,1,33,32,33,33,33,0,0,0,0,0,0,36047026400,11204
264,2001,2,36,33,36,36,36,0,0,0,0,0,0,36047026400,11204
264,2001,3,32,36,32,32,32,0,0,0,0,0,0,36047026400,11204
264,2001,4,36,32,36,36,36,0,0,0,0,0,0,36047026400,11204
264,2001,5,39,36,39,39,39,0,0,0,0,0,0,36047026400,11204
264,2002,0,33,33,32,33,33,0.03125,1,0,0,0,0,36047026400,11204
264,2002,1,31,33,33,31,31,-0.060606,-2,0,0,0,0,36047026400,11204
264,2002,2,36,31,36,36,36,0,0,0,0,0,0,36047026400,11204
264,2002,3,31,36,32,31,31,-0.03125,-1,0,0,0,0,36047026400,11204
264,2002,4,36,31,36,36,36,0,0,0,0,0,0,36047026400,11204
264,2002,5,39,36,39,39,39,0,0,0,0,0,0,36047026400,11204
264,2003,0,41,41,33,41,41,0.242424,8,0,0,0,0,36047026400,11204
264,2003,1,35,41,31,35,35,0.129032,4,0,0,0,0,36047026400,11204
264,2003,2,32,35,36,32,32,-0.111111,-4,0,0,0,0,36047026400,11204
264,2003,3,44,32,31,44,44,0.419355,13,0,0,0,0,36047026400,11204
264,2003,4,30,44,36,30,30,-0.166667,-6,0,0,0,0,36047026400,11204
264,2003,5,37,30,39,37,37,-0.051282,-2,0,0,0,0,36047026400,11204
264,2004,0,27,27,41,32,32,-0.341463,-14,-0.15625,-5,-0.15625,-5,36047026400,11204
264,2004,1,46,27,35,33,33,0.314286,11,0.393939,13,0.393939,13,36047026400,11204
264,2004,2,40,46,32,36,36,0.25,8,0.111111,4,0.111111,4,36047026400,11204
264,2004,3,35,40,44,32,32,-0.204545,-9,0.09375,3,0.09375,3,36047026400,11204
264,2004,4,47,35,30,36,36,0.566667,17,0.305556,11,0.305556,11,36047026400,11204
264,2004,5,31,47,37,39,39,-0.162162,-6,-0.205128,-8,-0.205128,-8,36047026400,11204
264,2005,0,37,37,27,33,33,0.37037,10,0.121212,4,0.121212,4,36047026400,11204
264,2005,1,25,37,46,31,31,-0.456522,-21,-0.193548,-6,-0.193548,-6,36047026400,11204
264,2005,2,42,25,40,36,36,0.05,2,0.166667,6,0.166667,6,36047026400,11204
264,2005,3,45,42,35,31,31,0.285714,10,0.451613,14,0.451613,14,36047026400,11204
264,2005,4,37,45,47,36,36,-0.212766,-10,0.027778,1,0.027778,1,36047026400,11204
264,2005,5,43,37,31,39,39,0.387097,12,0.102564,4,0.102564,4,36047026400,11204
264,2006,0,35,35,37,41,41,-0.054054,-2,-0.146341,-6,-0.146341,-6,36047026400,11204
264,2006,1,38,35,25,35,35,0.52,13,0.085714,3,0.085714,3,36047026400,11204
264,2006,2,23,38,42,32,32,-0.452381,-19,-0.28125,-9,-0.28125,-9,36047026400,11204
264,2006,3,41,23,45,44,44,-0.088889,-4,-0.068182,-3,-0.068182,-3,36047026400,11204
264,2006,4,38,41,37,30,30,0.027027,1,0.266667,8,0.266667,8,36047026400,11204
264,2006,5,34,38,43,37,37,-0.209302,-9,-0.081081,-3,-0.081081,-3,36047026400,11204
264,2007,0,37,37,35,27,27,0.057143,2,0.37037,10,0.37037,10,36047026400,11204
264,2007,1,43,37,38,46,46,0.131579,5,-0.065217,-3,-0.065217,-3,36047026400,11204
264,2007,2,41,43,23,40,40,0.782609,18,0.025,1,0.025,1,36047026400,11204
264,2007,3,24,41,41,35,35,-0.414634,-17,-0.314286,-11,-0.314286,-11,36047026400,11204
264,2007,4,41,24,38,47,47,0.078947,3,-0.12766,-6,-0.12766,-6,36047026400,11204
264,2007,5,42,41,34,31,31,0.235294,8,0.354839,11,0.354839,11,36047026400,11204
264,2008,0,27,27,37,37,37,-0.27027,-10,-0.27027,-10,-0.27027,-10,36047026400,11204
264,2008,1,40,27,43,25,25,-0.069767,-3,0.6,15,0.6,15,36047026400,11204
264,2008,2,46,40,41,42,42,0.121951,5,0.095238,4,0.095238,4,36047026400,11204
264,2008,3,39,46,24,45,45,0.625,15,-0.133333,-6,-0.133333,-6,36047026400,11204
264,2008,4,25,39,41,37,37,-0.390244,-16,-0.324324,-12,-0.324324,-12,36047026400,11204
264,2008,5,40,25,42,43,43,-0.047619,-2,-0.069767,-3,-0.069767,-3,36047026400,11204
264,2009,0,40,40,27,35,35,0.481481,13,0.142857,5,0.142857,5,36047026400,11204
264,2009,1,31,40,40,38,38,-0.225,-9,-0.184211,-7,-0.184211,-7,36047026400,11204
264,2009,2,38,31,46,23,23,-0.173913,-8,0.652174,15,0.652174,15,36047026400,11204
264,2009,3,44,38,39,41,41,0.128205,5,0.073171,3,0.073171,3,36047026400,11204
264,2009,4,41,44,25,38,38,0.64,16,0.078947,3,0.078947,3,36047026400,11204
264,2009,5,31,41,40,34,34,-0.225,-9,-0.088235,-3,-0.088235,-3,36047026400,11204
264,2010,0,46,46,40,37,37,0.15,6,0.243243,9,0.243243,9,36047026400,11204
264,2010,1,45,46,31,43,43,0.451613,14,0.046512,2,0.046512,2,36047026400,11204
264,2010,2,39,45,38,41,41,0.026316,1,-0.04878,-2,-0.04878,-2,36047026400,11204
264,2010,3,44,39,44,24,24,0,0,0.833333,20,0.833333,20,36047026400,11204
264,2010,4,39,44,41,41,41,-0.04878,-2,-0.04878,-2,-0.04878,-2,36047026400,11204
264,2010,5,37,39,31,42,42,0.193548,6,-0.119048,-5,-0.119048,-5,36047026400,11204
266,2001,0,43,43,43,43,43,0,0,0,0,0,0,36047026600,11204
266,2001,1,44,43,44,44,44,0,0,0,0,0,0,36047026600,11204
266,2001,2,32,44,32,32,32,0,0,0,0,0,0,36047026600,11204
266,2001,3,32,32,32,32,32,0,0,0,0,0,0,36047026600,11204
266,2001,4,34,32,34,34,34,0,0,0,0,0,0,36047026600,11204
266,2001,5,32,34,32,32,32,0,0,0,0,0,0,36047026600,11204
266,2002,0,44,44,43,44,44,0.023256,1,0,0,0,0,36047026600,11204
266,2002,1,43,44,44,43,43,-0.022727,-1,0,0,0,0,36047026600,11204
266,2002,2,38,43,32,38,38,0.1875,6,0,0,0,0,36047026600,11204
266,2002,3,31,38,32,31,31,-0.03125,-1,0,0,0,0,36047026600,11204
266,2002,4,33,31,34,33,33,-0.029412,-1,0,0,0,0,36047026600,11204
266,2002,5,32,33,32,32,32,0,0,0,0,0,0,36047026600,11204
266,2003,0,40,40,44,40,40,-0.090909,-4,0,0,0,0,36047026600,11204
266,2003,1,46,40,43,46,46,0.069767,3,0,0,0,0,36047026600,11204
266,2003,2,45,46,38,45,45,0.184211,7,0,0,0,0,36047026600,11204
266,2003,3,40,45,31,40,40,0.290323,9,0,0,0,0,36047026600,11204
266,2003,4,27,40,33,27,27,-0.181818,-6,0,0,0,0,36047026600,11204
266,2003,5,33,27,32,33,33,0.03125,1,0,0,0,0,36047026600,11204
266,2004,0,30,30,40,43,43,-0.25,-10,-0.302326,-13,-0.302326,-13,36047026600,11204
266,2004,1,42,30,46,44,44,-0.086957,-4,-0.045455,-2,-0.045455,-2,36047026600,11204
266,2004,2,46,42,45,32,32,0.022222,1,0.4375,14,0.4375,14,36047026600,11204
266,2004,3,38,46,40,32,32,-0.05,-2,0.1875,6,0.1875,6,36047026600,11204
266,2004,4,36,38,27,34,34,0.333333,9,0.058824,2,0.058824,2,36047026600,11204
266,2004,5,30,36,33,32,32,-0.090909,-3,-0.0625,-2,-0.0625,-2,36047026600,11204
266,2005,0,36,36,30,44,44,0.2,6,-0.181818,-8,-0.181818,-8,36047026600,11204
266,2005,1,36,36,42,43,43,-0.142857,-6,-0.162791,-7,-0.162791,-7,36047026600,11204
266,2005,2,36,36,46,38,38,-0.217391,-10,-0.052632,-2,-0.052632,-2,36047026600,11204
266,2005,3,43,36,38,31,31,0.131579,5,0.387097,12,0.387097,12,36047026600,11204
266,2005,4,40,43,36,33,33,0.111111,4,0.212121,7,0.212121,7,36047026600,11204
266,2005,5,41,40,30,32,32,0.366667,11,0.28125,9,0.28125,9,36047026600,11204
266,2006,0,38,38,36,40,40,0.055556,2,-0.05,-2,-0.05,-2,36047026600,11204
266,2006,1,38,38,36,46,46,0.055556,2,-0.173913,-8,-0.173913,-8,36047026600,11204
266,2006,2,33,38,36,45,45,-0.083333,-3,-0.266667,-12,-0.266667,-12,36047026600,11204
266,2006,3,38,33,43,40,40,-0.116279,-5,-0.05,-2,-0.05,-2,36047026600,11204
266,2006,4,48,38,40,27,27,0.2,8,0.777778,21,0.777778,21,36047026600,11204
266,2006,5,32,48,41,33,33,-0.219512,-9,-0.030303,-1,-0.030303,-1,36047026600,11204
266,2007,0,33,33,38,30,30,-0.131579,-5,0.1,3,0.1,3,36047026600,11204
266,2007,1,39,33,38,42,42,0.026316,1,-0.071429,-3,-0.071429,-3,36047026600,11204
266,2007,2,38,39,33,46,46,0.151515,5,-0.173913,-8,-0.173913,-8,36047026600,11204
266,2007,3,29,38,38,38,38,-0.236842,-9,-0.236842,-9,-0.236842,-9,36047026600,11204
266,2007,4,37,29,48,36,36,-0.229167,-11,0.027778,1,0.027778,1,36047026600,11204
266,2007,5,48,37,32,30,30,0.5,16,0.6,18,0.6,18,36047026600,11204
266,2008,0,36,36,33,36,36,0.090909,3,0,0,0,0,36047026600,11204
266,2008,1,30,36,39,36,36,-0.230769,-9,-0.166667,-6,-0.166667,-6,36047026600,11204
266,2008,2,35,30,38,36,36,-0.078947,-3,-0.027778,-1,-0.027778,-1,36047026600,11204
266,2008,3,32,35,29,43,43,0.103448,3,-0.255814,-11,-0.255814,-11,36047026600,11204
266,2008,4,29,32,37,40,40,-0.216216,-8,-0.275,-11,-0.275,-11,36047026600,11204
266,2008,5,39,29,48,41,41,-0.1875,-9,-0.04878,-2,-0.04878,-2,36047026600,11204
266,2009,0,46,46,36,38,38,0.277778,10,0.210526,8,0.210526,8,36047026600,11204
266,2009,1,34,46,30,38,38,0.133333,4,-0.105263,-4,-0.105263,-4,36047026600,11204
266,2009,2,34,34,35,33,33,-0.028571,-1,0.030303,1,0.030303,1,36047026600,11204
266,2009,3,32,34,32,38,38,0,0,-0.157895,-6,-0.157895,-6,36047026600,11204
266,2009,4,31,32,29,48,48,0.068966,2,-0.354167,-17,-0.354167,-17,36047026600,11204
266,2009,5,30,31,39,32,32,-0.230769,-9,-0.0625,-2,-0.0625,-2,36047026600,11204
266,2010,0,44,44,46,33,33,-0.043478,-2,0.333333,11,0.333333,11,36047026600,11204
266,2010,1,47,44,34,39,39,0.382353,13,0.205128,8,0.205128,8,36047026600,11204
266,2010,2,31,47,34,38,38,-0.088235,-3,-0.184211,-7,-0.184211,-7,36047026600,11204
266,2010,3,33,31,32,29,29,0.03125,1,0.137931,4,0.137931,4,36047026600,11204
266,2010,4,38,33,31,37,37,0.225806,7,0.027027,1,0.027027,1,36047026600,11204
266,2010,5,39,38,30,48,48,0.3,9,-0.1875,-9,-0.1875,-9,36047026600,11204
268,2001,0,36,36,36,36,36,0,0,0,0,0,0,36047026800,11204
268,2001,1,25,36,25,25,25,0,0,0,0,0,0,36047026800,11204
268,2001,2,33,25,33,33,33,0,0,0,0,0,0,36047026800,11204
268,2001,3,25,33,25,25,25,0,0,0,0,0,0,36047026800,11204
268,2001,4,21,25,21,21,21,0,0,0,0,0,0,36047026800,11204
268,2001,5,30,21,30,30,30,0,0,0,0,0,0,36047026800,11204
268,2002,0,24,24,36,24,24,-0.333333,-12,0,0,0,0,36047026800,11204
268,2002,1,36,24,25,36,36,0.44,11,0,0,0,0,36047026800,11204
268,2002,2,29,36,33,29,29,-0.121212,-4,0,0,0,0,36047026800,11204
268,2002,3,37,29,25,37,37,0.48,12,0,0,0,0,36047026800,11204
268,2002,4,29,37,21,29,29,0.380952,8,0,0,0,0,36047026800,11204
268,2002,5,17,29,30,17,17,-0.433333,-13,0,0,0,0,36047026800,11204
268,2003,0,30,30,24,30,30,0.25,6,0,0,0,0,36047026800,11204
268,2003,1,19,30,36,19,19,-0.472222,-17,0,0,0,0,36047026800,11204
268,2003,2,39,19,29,39,39,0.344828,10,0,0,0,0,36047026800,11204
268,2003,3,33,39,37,33,33,-0.108108,-4,0,0,0,0,36047026800,11204
268,2003,4,32,33,29,32,32,0.103448,3,0,0,0,0,36047026800,11204
268,2003,5,28,32,17,28,28,0.647059,11,0,0,0,0,36047026800,11204
268,2004,0,31,31,30,36,36,0.033333,1,-0.138889,-5,-0.138889,-5,36047026800,11204
268,2004,1,37,31,19,25,25,0.947368,18,0.48,12,0.48,12,36047026800,11204
268,2004,2,20,37,39,33,33,-0.487179,-19,-0.393939,-13,-0.393939,-13,36047026800,11204
268,2004,3,45,20,33,25,25,0.363636,12,0.8,20,0.8,20,36047026800,11204
268,2004,4,34,45,32,21,21,0.0625,2,0.619048,13,0.619048,13,36047026800,11204
268,2004,5,28,34,28,30,30,0,0,-0.066667,-2,-0.066667,-2,36047026800,11204
268,2005,0,38,38,31,24,24,0.225806,7,0.583333,14,0.583333,14,36047026800,11204
268,2005,1,33,38,37,36,36,-0.108108,-4,-0.083333,-3,-0.083333,-3,36047026800,11204
268,2005,2,35,33,20,29,29,0.75,15,0.206897,6,0.206897,6,36047026800,11204
268,2005,3,28,35,45,37,37,-0.377778,-17,-0.243243,-9,-0.243243,-9,36047026800,11204
268,2005,4,48,28,34,29,29,0.411765,14,0.655172,19,0.655172,19,36047026800,11204
268,2005,5,33,48,28,17,17,0.178571,5,0.941176,16,0.941176,16,36047026800,11204
268,2006,0,47,47,38,30,30,0.236842,9,0.566667,17,0.566667,17,36047026800,11204
268,2006,1,39,47,33,19,19,0.181818,6,1.052632,20,1.052632,20,36047026800,11204
268,2006,2,41,39,35,39,39,0.171429,6,0.051282,2,0.051282,2,36047026800,11204
268,2006,3,36,41,28,33,33,0.285714,8,0.090909,3,0.090909,3,36047026800,11204
268,2006,4,33,36,48,32,32,-0.3125,-15,0.03125,1,0.03125,1,36047026800,11204
268,2006,5,44,33,33,28,28,0.333333,11,0.571429,16,0.571429,16,36047026800,11204
268,2007,0,38,38,47,31,31,-0.191489,-9,0.225806,7,0.225806,7,36047026800,11204
268,2007,1,46,38,39,37,37,0.179487,7,0.243243,9,0.243243,9,36047026800,11204
268,2007,2,39,46,41,20,20,-0.04878,-2,0.95,19,0.95,19,36047026800,11204
268,2007,3,43,39,36,45,45,0.194444,7,-0.044444,-2,-0.044444,-2,36047026800,11204
268,2007,4,35,43,33,34,34,0.060606,2,0.029412,1,0.029412,1,36047026800,11204
268,2007,5,35,35,44,28,28,-0.204545,-9,0.25,7,0.25,7,36047026800,11204
268,2008,0,44,44,38,38,38,0.157895,6,0.157895,6,0.157895,6,36047026800,11204
268,2008,1,39,44,46,33,33,-0.152174,-7,0.181818,6,0.181818,6,36047026800,11204
268,2008,2,49,39,39,35,35,0.25641,10,0.4,14,0.4,14,36047026800,11204
268,2008,3,37,49,43,28,28,-0.139535,-6,0.321429,9,0.321429,9,36047026800,11204
268,2008,4,40,37,35,48,48,0.142857,5,-0.166667,-8,-0.166667,-8,36047026800,11204
268,2008,5,38,40,35,33,33,0.085714,3,0.151515,5,0.151515,5,36047026800,11204
268,2009,0,40,40,44,47,47,-0.090909,-4,-0.148936,-7,-0.148936,-7,36047026800,11204
268,2009,1,53,40,39,39,39,0.358974,14,0.358974,14,0.358974,14,36047026800,11204
268,2009,2,48,53,49,41,41,-0.020408,-1,0.170732,7,0.170732,7,36047026800,11204
268,2009,3,52,48,37,36,36,0.405405,15,0.444444,16,0.444444,16,36047026800,11204
268,2009,4,42,52,40,33,33,0.05,2,0.272727,9,0.272727,9,36047026800,11204
268,2009,5,39,42,38,44,44,0.026316,1,-0.113636,-5,-0.113636,-5,36047026800,11204
268,2010,0,55,55,40,38,38,0.375,15,0.447368,17,0.447368,17,36047026800,11204
268,2010,1,40,55,53,46,46,-0.245283,-13,-0.130435,-6,-0.130435,-6,36047026800,11204
268,2010,2,61,40,48,39,39,0.270833,13,0.564103,22,0.564103,22,36047026800,11204
268,2010,3,46,61,52,43,43,-0.115385,-6,0.069767,3,0.069767,3,36047026800,11204
268,2010,4,55,46,42,35,35,0.309524,13,0.571429,20,0.571429,20,36047026800,11204
268,2010,5,44,55,39,35,35,0.128205,5,0.257143,9,0.257143,9,36047026800,11204
270,2001,0,2,2,2,2,2,0,0,0,0,0,0,36047027000,11214
270,2001,1,12,2,12,12,12,0,0,0,0,0,0,36047027000,11214
270,2001,2,6,12,6,6,6,0,0,0,0,0,0,36047027000,11214
270,2001,3,5,6,5,5,5,0,0,0,0,0,0,36047027000,11214
270,2001,4,3,5,3,3,3,0,0,0,0,0,0,36047027000,11214
270,2001,5,8,3,8,8,8,0,0,0,0,0,0,36047027000,11214
270,2002,0,8,8,2,8,8,3,6,0,0,0,0,36047027000,11214
270,2002,1,2,8,12,2,2,-0.833333,-10,0,0,0,0,36047027000,11214
270,2002,2,11,2,6,11,11,0.833333,5,0,0,0,0,36047027000,11214
270,2002,3,6,11,5,6,6,0.2,1,0,0,0,0,36047027000,11214
270,2002,4,7,6,3,7,7,1.333333,4,0,0,0,0,36047027000,11214
270,2002,5,3,7,8,3,3,-0.625,-5,0,0,0,0,36047027000,11214
270,2003,0,4,4,8,4,4,-0.5,-4,0,0,0,0,36047027000,11214
270,2003,1,9,4,2,9,9,3.5,7,0,0,0,0,36047027000,11214
270,2003,2,2,9,11,2,2,-0.818182,-9,0,0,0,0,36047027000,11214
270,2003,3,10,2,6,10,10,0.666667,4,0,0,0,0,36047027000,11214
270,2003,4,7,10,7,7,7,0,0,0,0,0,0,36047027000,11214
270,2003,5,8,7,3,8,8,1.666667,5,0,0,0,0,36047027000,11214
270,2004,0,4,4,4,2,2,0,0,1,2,1,2,36047027000,11214
270,2004,1,4,4,9,12,12,-0.555556,-5,-0.666667,-8,-0.666667,-8,36047027000,11214
270,2004,2,8,4,2,6,6,3,6,0.333333,2,0.333333,2,36047027000,11214
270,2004,3,2,8,10,5,5,-0.8,-8,-0.6,-3,-0.6,-3,36047027000,11214
270,2004,4,9,2,7,3,3,0.285714,2,2,6,2,6,36047027000,11214
270,2004,5,7,9,8,8,8,-0.125,-1,-0.125,-1,-0.125,-1,36047027000,11214
270,2005,0,3,3,4,8,8,-0.25,-1,-0.625,-5,-0.625,-5,36047027000,11214
270,2005,1,5,3,4,2,2,0.25,1,1.5,3,1.5,3,36047027000,11214
270,2005,2,3,5,8,11,11,-0.625,-5,-0.727273,-8,-0.727273,-8,36047027000,11214
270,2005,3,8,3,2,6,6,3,6,0.333333,2,0.333333,2,36047027000,11214
270,2005,4,3,8,9,7,7,-0.666667,-6,-0.571429,-4,-0.571429,-4,36047027000,11214
270,2005,5,8,3,7,3,3,0.142857,1,1.666667,5,1.666667,5,36047027000,11214
270,2006,0,5,5,3,4,4,0.666667,2,0.25,1,0.25,1,36047027000,11214
270,2006,1,5,5,5,9,9,0,0,-0.444444,-4,-0.444444,-4,36047027000,11214
270,2006,2,5,5,3,2,2,0.666667,2,1.5,3,1.5,3,36047027000,11214
270,2006,3,3,5,8,10,10,-0.625,-5,-0.7,-7,-0.7,-7,36047027000,11214
270,2006,4,11,3,3,7,7,2.666667,8,0.571429,4,0.571429,4,36047027000,11214
270,2006,5,4,11,8,8,8,-0.5,-4,-0.5,-4,-0.5,-4,36047027000,11214
270,2007,0,3,3,5,4,4,-0.4,-2,-0.25,-1,-0.25,-1,36047027000,11214
270,2007,1,6,3,5,4,4,0.2,1,0.5,2,0.5,2,36047027000,11214
270,2007,2,3,6,5,8,8,-0.4,-2,-0.625,-5,-0.625,-5,36047027000,11214
270,2007,3,4,3,3,2,2,0.333333,1,1,2,1,2,36047027000,11214
270,2007,4,3,4,11,9,9,-0.727273,-8,-0.666667,-6,-0.666667,-6,36047027000,11214
270,2007,5,8,3,4,7,7,1,4,0.142857,1,0.142857,1,36047027000,11214
270,2008,0,1,1,3,3,3,-0.666667,-2,-0.666667,-2,-0.666667,-2,36047027000,11214
270,2008,1,3,1,6,5,5,-0.5,-3,-0.4,-2,-0.4,-2,36047027000,11214
270,2008,2,4,3,3,3,3,0.333333,1,0.333333,1,0.333333,1,36047027000,11214
270,2008,3,5,4,4,8,8,0.25,1,-0.375,-3,-0.375,-3,36047027000,11214
270,2008,4,4,5,3,3,3,0.333333,1,0.333333,1,0.333333,1,36047027000,11214
270,2008,5,3,4,8,8,8,-0.625,-5,-0.625,-5,-0.625,-5,36047027000,11214
270,2009,0,9,9,1,5,5,8,8,0.8,4,0.8,4,36047027000,11214
270,2009,1,1,9,3,5,5,-0.666667,-2,-0.8,-4,-0.8,-4,36047027000,11214
270,2009,2,4,1,4,5,5,0,0,-0.2,-1,-0.2,-1,36047027000,11214
270,2009,3,6,4,5,3,3,0.2,1,1,3,1,3,36047027000,11214
270,2009,4,7,6,4,11,11,0.75,3,-0.363636,-4,-0.363636,-4,36047027000,11214
270,2009,5,5,7,3,4,4,0.666667,2,0.25,1,0.25,1,36047027000,11214
270,2010,0,9,9,9,3,3,0,0,2,6,2,6,36047027000,11214
270,2010,1,10,9,1,6,6,9,9,0.666667,4,0.666667,4,36047027000,11214
270,2010,2,3,10,4,3,3,-0.25,-1,0,0,0,0,36047027000,11214
270,2010,3,4,3,6,4,4,-0.333333,-2,0,0,0,0,36047027000,11214
270,2010,4,6,4,7,3,3,-0.142857,-1,1,3,1,3,36047027000,11214
270,2010,5,6,6,5,8,8,0.2,1,-0.25,-2,-0.25,-2,36047027000,11214
272,2001,0,19,19,19,19,19,0,0,0,0,0,0,36047027200,11214
272,2001,1,36,19,36,36,36,0,0,0,0,0,0,36047027200,11214
272,2001,2,37,36,37,37,37,0,0,0,0,0,0,36047027200,11214
272,2001,3,29,37,29,29,29,0,0,0,0,0,0,36047027200,11214
272,2001,4,20,29,20,20,20,0,0,0,0,0,0,36047027200,11214
272,2001,5,34,20,34,34,34,0,0,0,0,0,0,36047027200,11214
272,2002,0,22,22,19,22,22,0.157895,3,0,0,0,0,36047027200,11214
272,2002,1,27,22,36,27,27,-0.25,-9,0,0,0,0,36047027200,11214
272,2002,2,31,27,37,31,31,-0.162162,-6,0,0,0,0,36047027200,11214
272,2002,3,32,31,29,32,32,0.103448,3,0,0,0,0,36047027200,11214
272,2002,4,33,32,20,33,33,0.65,13,0,0,0,0,36047027200,11214
272,2002,5,17,33,34,17,17,-0.5,-17,0,0,0,0,36047027200,11214
272,2003,0,24,24,22,24,24,0.090909,2,0,0,0,0,36047027200,11214
272,2003,1,20,24,27,20,20,-0.259259,-7,0,0,0,0,36047027200,11214
272,2003,2,30,20,31,30,30,-0.032258,-1,0,0,0,0,36047027200,11214
272,2003,3,29,30,32,29,29,-0.09375,-3,0,0,0,0,36047027200,11214
272,2003,4,37,29,33,37,37,0.121212,4,0,0,0,0,36047027200,11214
272,2003,5,29,37,17,29,29,0.705882,12,0,0,0,0,36047027200,11214
272,2004,0,25,25,24,19,19,0.041667,1,0.315789,6,0.315789,6,36047027200,11214
272,2004,1,26,25,20,36,36,0.3,6,-0.277778,-10,-0.277778,-10,36047027200,11214
272,2004,2,18,26,30,37,37,-0.4,-12,-0.513514,-19,-0.513514,-19,36047027200,11214
272,2004,3,31,18,29,29,29,0.068966,2,0.068966,2,0.068966,2,36047027200,11214
272,2004,4,32,31,37,20,20,-0.135135,-5,0.6,12,0.6,12,36047027200,11214
272,2004,5,33,32,29,34,34,0.137931,4,-0.029412,-1,-0.029412,-1,36047027200,11214
272,2005,0,24,24,25,22,22,-0.04,-1,0.090909,2,0.090909,2,36047027200,11214
272,2005,1,23,24,26,27,27,-0.115385,-3,-0.148148,-4,-0.148148,-4,36047027200,11214
272,2005,2,22,23,18,31,31,0.222222,4,-0.290323,-9,-0.290323,-9,36047027200,11214
272,2005,3,21,22,31,32,32,-0.322581,-10,-0.34375,-11,-0.34375,-11,36047027200,11214
272,2005,4,27,21,32,33,33,-0.15625,-5,-0.181818,-6,-0.181818,-6,36047027200,11214
272,2005,5,30,27,33,17,17,-0.090909,-3,0.764706,13,0.764706,13,36047027200,11214
272,2006,0,17,17,24,24,24,-0.291667,-7,-0.291667,-7,-0.291667,-7,36047027200,11214
272,2006,1,27,17,23,20,20,0.173913,4,0.35,7,0.35,7,36047027200,11214
272,2006,2,26,27,22,30,30,0.181818,4,-0.133333,-4,-0.133333,-4,36047027200,11214
272,2006,3,22,26,21,29,29,0.047619,1,-0.241379,-7,-0.241379,-7,36047027200,11214
272,2006,4,20,22,27,37,37,-0.259259,-7,-0.459459,-17,-0.459459,-17,36047027200,11214
272,2006,5,27,20,30,29,29,-0.1,-3,-0.068966,-2,-0.068966,-2,36047027200,11214
272,2007,0,21,21,17,25,25,0.235294,4,-0.16,-4,-0.16,-4,36047027200,11214
272,2007,1,18,21,27,26,26,-0.333333,-9,-0.307692,-8,-0.307692,-8,36047027200,11214
272,2007,2,26,18,26,18,18,0,0,0.444444,8,0.444444,8,36047027200,11214
272,2007,3,23,26,22,31,31,0.045455,1,-0.258065,-8,-0.258065,-8,36047027200,11214
272,2007,4,23,23,20,32,32,0.15,3,-0.28125,-9,-0.28125,-9,36047027200,11214
272,2007,5,22,23,27,33,33,-0.185185,-5,-0.333333,-11,-0.333333,-11,36047027200,11214
272,2008,0,26,26,21,24,24,0.238095,5,0.083333,2,0.083333,2,36047027200,11214
272,2008,1,21,26,18,23,23,0.166667,3,-0.086957,-2,-0.086957,-2,36047027200,11214
272,2008,2,17,21,26,22,22,-0.346154,-9,-0.227273,-5,-0.227273,-5,36047027200,11214
272,2008,3,27,17,23,21,21,0.173913,4,0.285714,6,0.285714,6,36047027200,11214
272,2008,4,24,27,23,27,27,0.043478,1,-0.111111,-3,-0.111111,-3,36047027200,11214
272,2008,5,19,24,22,30,30,-0.136364,-3,-0.366667,-11,-0.366667,-11,36047027200,11214
272,2009,0,24,24,26,17,17,-0.076923,-2,0.411765,7,0.411765,7,36047027200,11214
272,2009,1,28,24,21,27,27,0.333333,7,0.037037,1,0.037037,1,36047027200,11214
272,2009,2,24,28,17,26,26,0.411765,7,-0.076923,-2,-0.076923,-2,36047027200,11214
272,2009,3,20,24,27,22,22,-0.259259,-7,-0.090909,-2,-0.090909,-2,36047027200,11214
272,2009,4,29,20,24,20,20,0.208333,5,0.45,9,0.45,9,36047027200,11214
272,2009,5,29,29,19,27,27,0.526316,10,0.074074,2,0.074074,2,36047027200,11214
272,2010,0,30,30,24,21,21,0.25,6,0.428571,9,0.428571,9,36047027200,11214
272,2010,1,24,30,28,18,18,-0.142857,-4,0.333333,6,0.333333,6,36047027200,11214
272,2010,2,25,24,24,26,26,0.041667,1,-0.038462,-1,-0.038462,-1,36047027200,11214
272,2010,3,24,25,20,23,23,0.2,4,0.043478,1,0.043478,1,36047027200,11214
272,2010,4,22,24,29,23,23,-0.241379,-7,-0.043478,-1,-0.043478,-1,36047027200,11214
272,2010,5,30,22,29,22,22,0.034483,1,0.363636,8,0.363636,8,36047027200,11214
274,2001,0,18,18,18,18,18,0,0,0,0,0,0,36047027400,11204
274,2001,1,22,18,22,22,22,0,0,0,0,0,0,36047027400,11204
274,2001,2,23,22,23,23,23,0,0,0,0,0,0,36047027400,11204
274,2001,3,29,23,29,29,29,0,0,0,0,0,0,36047027400,11204
274,2001,4,15,29,15,15,15,0,0,0,0,0,0,36047027400,11204
274,2001,5,24,15,24,24,24,0,0,0,0,0,0,36047027400,11204
274,2002,0,20,20,18,20,20,0.111111,2,0,0,0,0,36047027400,11204
274,2002,1,22,20,22,22,22,0,0,0,0,0,0,36047027400,11204
274,2002,2,25,22,23,25,25,0.086957,2,0,0,0,0,36047027400,11204
274,2002,3,20,25,29,20,20,-0.310345,-9,0,0,0,0,36047027400,11204
274,2002,4,27,20,15,27,27,0.8,12,0,0,0,0,36047027400,11204
274,2002,5,17,27,24,17,17,-0.291667,-7,0,0,0,0,36047027400,11204
274,2003,0,19,19,20,19,19,-0.05,-1,0,0,0,0,36047027400,11204
274,2003,1,23,19,22,23,23,0.045455,1,0,0,0,0,36047027400,11204
274,2003,2,22,23,25,22,22,-0.12,-3,0,0,0,0,36047027400,11204
274,2003,3,20,22,20,20,20,0,0,0,0,0,0,36047027400,11204
274,2003,4,20,20,27,20,20,-0.259259,-7,0,0,0,0,36047027400,11204
274,2003,5,26,20,17,26,26,0.529412,9,0,0,0,0,36047027400,11204
274,2004,0,23,23,19,18,18,0.210526,4,0.277778,5,0.277778,5,36047027400,11204
274,2004,1,25,23,23,22,22,0.086957,2,0.136364,3,0.136364,3,36047027400,11204
274,2004,2,26,25,22,23,23,0.181818,4,0.130435,3,0.130435,3,36047027400,11204
274,2004,3,17,26,20,29,29,-0.15,-3,-0.413793,-12,-0.413793,-12,36047027400,11204
274,2004,4,21,17,20,15,15,0.05,1,0.4,6,0.4,6,36047027400,11204
274,2004,5,25,21,26,24,24,-0.038462,-1,0.041667,1,0.041667,1,36047027400,11204
274,2005,0,33,33,23,20,20,0.434783,10,0.65,13,0.65,13,36047027400,11204
274,2005,1,24,33,25,22,22,-0.04,-1,0.090909,2,0.090909,2,36047027400,11204
274,2005,2,33,24,26,25,25,0.269231,7,0.32,8,0.32,8,36047027400,11204
274,2005,3,29,33,17,20,20,0.705882,12,0.45,9,0.45,9,36047027400,11204
274,2005,4,20,29,21,27,27,-0.047619,-1,-0.259259,-7,-0.259259,-7,36047027400,11204
274,2005,5,28,20,25,17,17,0.12,3,0.647059,11,0.647059,11,36047027400,11204
274,2006,0,27,27,33,19,19,-0.181818,-6,0.421053,8,0.421053,8,36047027400,11204
274,2006,1,28,27,24,23,23,0.166667,4,0.217391,5,0.217391,5,36047027400,11204
274,2006,2,32,28,33,22,22,-0.030303,-1,0.454545,10,0.454545,10,36047027400,11204
274,2006,3,31,32,29,20,20,0.068966,2,0.55,11,0.55,11,36047027400,11204
274,2006,4,30,31,20,20,20,0.5,10,0.5,10,0.5,10,36047027400,11204
274,2006,5,21,30,28,26,26,-0.25,-7,-0.192308,-5,-0.192308,-5,36047027400,11204
274,2007,0,24,24,27,23,23,-0.111111,-3,0.043478,1,0.043478,1,36047027400,11204
274,2007,1,26,24,28,25,25,-0.071429,-2,0.04,1,0.04,1,36047027400,11204
274,2007,2,29,26,32,26,26,-0.09375,-3,0.115385,3,0.115385,3,36047027400,11204
274,2007,3,29,29,31,17,17,-0.064516,-2,0.705882,12,0.705882,12,36047027400,11204
274,2007,4,28,29,30,21,21,-0.066667,-2,0.333333,7,0.333333,7,36047027400,11204
274,2007,5,27,28,21,25,25,0.285714,6,0.08,2,0.08,2,36047027400,11204
274,2008,0,26,26,24,33,33,0.083333,2,-0.212121,-7,-0.212121,-7,36047027400,11204
274,2008,1,33,26,26,24,24,0.269231,7,0.375,9,0.375,9,36047027400,11204
274,2008,2,25,33,29,33,33,-0.137931,-4,-0.242424,-8,-0.242424,-8,36047027400,11204
274,2008,3,35,25,29,29,29,0.206897,6,0.206897,6,0.206897,6,36047027400,11204
274,2008,4,34,35,28,20,20,0.214286,6,0.7,14,0.7,14,36047027400,11204
274,2008,5,24,34,27,28,28,-0.111111,-3,-0.142857,-4,-0.142857,-4,36047027400,11204
274,2009,0,27,27,26,27,27,0.038462,1,0,0,0,0,36047027400,11204
274,2009,1,26,27,33,28,28,-0.212121,-7,-0.071429,-2,-0.071429,-2,36047027400,11204
274,2009,2,33,26,25,32,32,0.32,8,0.03125,1,0.03125,1,36047027400,11204
274,2009,3,23,33,35,31,31,-0.342857,-12,-0.258065,-8,-0.258065,-8,36047027400,11204
274,2009,4,30,23,34,30,30,-0.117647,-4,0,0,0,0,36047027400,11204
274,2009,5,35,30,24,21,21,0.458333,11,0.666667,14,0.666667,14,36047027400,11204
274,2010,0,31,31,27,24,24,0.148148,4,0.291667,7,0.291667,7,36047027400,11204
274,2010,1,31,31,26,26,26,0.192308,5,0.192308,5,0.192308,5,36047027400,11204
274,2010,2,32,31,33,29,29,-0.030303,-1,0.103448,3,0.103448,3,36047027400,11204
274,2010,3,37,32,23,29,29,0.608696,14,0.275862,8,0.275862,8,36047027400,11204
274,2010,4,28,37,30,28,28,-0.066667,-2,0,0,0,0,36047027400,11204
274,2010,5,35,28,35,27,27,0,0,0.296296,8,0.296296,8,36047027400,11204
276,2001,0,36,36,36,36,36,0,0,0,0,0,0,36047027600,11214
276,2001,1,37,36,37,37,37,0,0,0,0,0,0,36047027600,11214
276,2001,2,30,37,30,30,30,0,0,0,0,0,0,36047027600,11214
276,2001,3,25,30,25,25,25,0,0,0,0,0,0,36047027600,11214
276,2001,4,27,25,27,27,27,0,0,0,0,0,0,36047027600,11214
276,2001,5,33,27,33,33,33,0,0,0,0,0,0,36047027600,11214
276,2002,0,23,23,36,23,23,-0.361111,-13,0,0,0,0,36047027600,11214
276,2002,1,41,23,37,41,41,0.108108,4,0,0,0,0,36047027600,11214
276,2002,2,32,41,30,32,32,0.066667,2,0,0,0,0,36047027600,11214
276,2002,3,27,32,25,27,27,0.08,2,0,0,0,0,36047027600,11214
276,2002,4,22,27,27,22,22,-0.185185,-5,0,0,0,0,36047027600,11214
276,2002,5,27,22,33,27,27,-0.181818,-6,0,0,0,0,36047027600,11214
276,2003,0,23,23,23,23,23,0,0,0,0,0,0,36047027600,11214
276,2003,1,26,23,41,26,26,-0.365854,-15,0,0,0,0,36047027600,11214
276,2003,2,43,26,32,43,43,0.34375,11,0,0,0,0,36047027600,11214
276,2003,3,30,43,27,30,30,0.111111,3,0,0,0,0,36047027600,11214
276,2003,4,27,30,22,27,27,0.227273,5,0,0,0,0,36047027600,11214
276,2003,5,18,27,27,18,18,-0.333333,-9,0,0,0,0,36047027600,11214
276,2004,0,40,40,23,36,36,0.73913,17,0.111111,4,0.111111,4,36047027600,11214
276,2004,1,27,40,26,37,37,0.038462,1,-0.27027,-10,-0.27027,-10,36047027600,11214
276,2004,2,24,27,43,30,30,-0.44186,-19,-0.2,-6,-0.2,-6,36047027600,11214
276,2004,3,40,24,30,25,25,0.333333,10,0.6,15,0.6,15,36047027600,11214
276,2004,4,29,40,27,27,27,0.074074,2,0.074074,2,0.074074,2,36047027600,11214
276,2004,5,29,29,18,33,33,0.611111,11,-0.121212,-4,-0.121212,-4,36047027600,11214
276,2005,0,32,32,40,23,23,-0.2,-8,0.391304,9,0.391304,9,36047027600,11214
276,2005,1,40,32,27,41,41,0.481481,13,-0.02439,-1,-0.02439,-1,36047027600,11214
276,2005,2,29,40,24,32,32,0.208333,5,-0.09375,-3,-0.09375,-3,36047027600,11214
276,2005,3,26,29,40,27,27,-0.35,-14,-0.037037,-1,-0.037037,-1,36047027600,11214
276,2005,4,41,26,29,22,22,0.413793,12,0.863636,19,0.863636,19,36047027600,11214
276,2005,5,28,41,29,27,27,-0.034483,-1,0.037037,1,0.037037,1,36047027600,11214
276,2006,0,29,29,32,23,23,-0.09375,-3,0.26087,6,0.26087,6,36047027600,11214
276,2006,1,33,29,40,26,26,-0.175,-7,0.269231,7,0.269231,7,36047027600,11214
276,2006,2,40,33,29,43,43,0.37931,11,-0.069767,-3,-0.069767,-3,36047027600,11214
276,2006,3,32,40,26,30,30,0.230769,6,0.066667,2,0.066667,2,36047027600,11214
276,2006,4,29,32,41,27,27,-0.292683,-12,0.074074,2,0.074074,2,36047027600,11214
276,2006,5,44,29,28,18,18,0.571429,16,1.444444,26,1.444444,26,36047027600,11214
276,2007,0,22,22,29,40,40,-0.241379,-7,-0.45,-18,-0.45,-18,36047027600,11214
276,2007,1,33,22,33,27,27,0,0,0.222222,6,0.222222,6,36047027600,11214
276,2007,2,32,33,40,24,24,-0.2,-8,0.333333,8,0.333333,8,36047027600,11214
276,2007,3,39,32,32,40,40,0.21875,7,-0.025,-1,-0.025,-1,36047027600,11214
276,2007,4,30,39,29,29,29,0.034483,1,0.034483,1,0.034483,1,36047027600,11214
276,2007,5,35,30,44,29,29,-0.204545,-9,0.206897,6,0.206897,6,36047027600,11214
276,2008,0,37,37,22,32,32,0.681818,15,0.15625,5,0.15625,5,36047027600,11214
276,2008,1,32,37,33,40,40,-0.030303,-1,-0.2,-8,-0.2,-8,36047027600,11214
276,2008,2,37,32,32,29,29,0.15625,5,0.275862,8,0.275862,8,36047027600,11214
276,2008,3,33,37,39,26,26,-0.153846,-6,0.269231,7,0.269231,7,36047027600,11214
276,2008,4,34,33,30,41,41,0.133333,4,-0.170732,-7,-0.170732,-7,36047027600,11214
276,2008,5,34,34,35,28,28,-0.028571,-1,0.214286,6,0.214286,6,36047027600,11214
276,2009,0,46,46,37,29,29,0.243243,9,0.586207,17,0.586207,17,36047027600,11214
276,2009,1,43,46,32,33,33,0.34375,11,0.30303,10,0.30303,10,36047027600,11214
276,2009,2,34,43,37,40,40,-0.081081,-3,-0.15,-6,-0.15,-6,36047027600,11214
276,2009,3,37,34,33,32,32,0.121212,4,0.15625,5,0.15625,5,36047027600,11214
276,2009,4,34,37,34,29,29,0,0,0.172414,5,0.172414,5,36047027600,11214
276,2009,5,34,34,34,44,44,0,0,-0.227273,-10,-0.227273,-10,36047027600,11214
276,2010,0,51,51,46,22,22,0.108696,5,1.318182,29,1.318182,29,36047027600,11214
276,2010,1,49,51,43,33,33,0.139535,6,0.484848,16,0.484848,16,36047027600,11214
276,2010,2,44,49,34,32,32,0.294118,10,0.375,12,0.375,12,36047027600,11214
276,2010,3,31,44,37,39,39,-0.162162,-6,-0.205128,-8,-0.205128,-8,36047027600,11214
276,2010,4,39,31,34,30,30,0.147059,5,0.3,9,0.3,9,36047027600,11214
276,2010,5,31,39,34,35,35,-0.088235,-3,-0.114286,-4,-0.114286,-4,36047027600,11214
278,2001,0,20,20,20,20,20,0,0,0,0,0,0,36047027800,11214
278,2001,1,24,20,24,24,24,0,0,0,0,0,0,36047027800,11214
278,2001,2,20,24,20,20,20,0,0,0,0,0,0,36047027800,11214
278,2001,3,21,20,21,21,21,0,0,0,0,0,0,36047027800,11214
278,2001,4,27,21,27,27,27,0,0,0,0,0,0,36047027800,11214
278,2001,5,23,27,23,23,23,0,0,0,0,0,0,36047027800,11214
278,2002,0,29,29,20,29,29,0.45,9,0,0,0,0,36047027800,11214
278,2002,1,20,29,24,20,20,-0.166667,-4,0,0,0,0,36047027800,11214
278,2002,2,27,20,20,27,27,0.35,7,0,0,0,0,36047027800,11214
278,2002,3,22,27,21,22,22,0.047619,1,0,0,0,0,36047027800,11214
278,2002,4,22,22,27,22,22,-0.185185,-5,0,0,0,0,36047027800,11214
278,2002,5,27,22,23,27,27,0.173913,4,0,0,0,0,36047027800,11214
278,2003,0,22,22,29,22,22,-0.241379,-7,0,0,0,0,36047027800,11214
278,2003,1,29,22,20,29,29,0.45,9,0,0,0,0,36047027800,11214
278,2003,2,18,29,27,18,18,-0.333333,-9,0,0,0,0,36047027800,11214
278,2003,3,30,18,22,30,30,0.363636,8,0,0,0,0,36047027800,11214
278,2003,4,21,30,22,21,21,-0.045455,-1,0,0,0,0,36047027800,11214
278,2003,5,21,21,27,21,21,-0.222222,-6,0,0,0,0,36047027800,11214
278,2004,0,25,25,22,20,20,0.136364,3,0.25,5,0.25,5,36047027800,11214
278,2004,1,23,25,29,24,24,-0.206897,-6,-0.041667,-1,-0.041667,-1,36047027800,11214
278,2004,2,27,23,18,20,20,0.5,9,0.35,7,0.35,7,36047027800,11214
278,2004,3,14,27,30,21,21,-0.533333,-16,-0.333333,-7,-0.333333,-7,36047027800,11214
278,2004,4,33,14,21,27,27,0.571429,12,0.222222,6,0.222222,6,36047027800,11214
278,2004,5,21,33,21,23,23,0,0,-0.086957,-2,-0.086957,-2,36047027800,11214
278,2005,0,13,13,25,29,29,-0.48,-12,-0.551724,-16,-0.551724,-16,36047027800,11214
278,2005,1,27,13,23,20,20,0.173913,4,0.35,7,0.35,7,36047027800,11214
278,2005,2,26,27,27,27,27,-0.037037,-1,-0.037037,-1,-0.037037,-1,36047027800,11214
278,2005,3,29,26,14,22,22,1.071429,15,0.318182,7,0.318182,7,36047027800,11214
278,2005,4,19,29,33,22,22,-0.424242,-14,-0.136364,-3,-0.136364,-3,36047027800,11214
278,2005,5,30,19,21,27,27,0.428571,9,0.111111,3,0.111111,3,36047027800,11214
278,2006,0,19,19,13,22,22,0.461538,6,-0.136364,-3,-0.136364,-3,36047027800,11214
278,2006,1,25,19,27,29,29,-0.074074,-2,-0.137931,-4,-0.137931,-4,36047027800,11214
278,2006,2,21,25,26,18,18,-0.192308,-5,0.166667,3,0.166667,3,36047027800,11214
278,2006,3,27,21,29,30,30,-0.068966,-2,-0.1,-3,-0.1,-3,36047027800,11214
278,2006,4,27,27,19,21,21,0.421053,8,0.285714,6,0.285714,6,36047027800,11214
278,2006,5,19,27,30,21,21,-0.366667,-11,-0.095238,-2,-0.095238,-2,36047027800,11214
278,2007,0,26,26,19,25,25,0.368421,7,0.04,1,0.04,1,36047027800,11214
278,2007,1,21,26,25,23,23,-0.16,-4,-0.086957,-2,-0.086957,-2,36047027800,11214
278,2007,2,22,21,21,27,27,0.047619,1,-0.185185,-5,-0.185185,-5,36047027800,11214
278,2007,3,21,22,27,14,14,-0.222222,-6,0.5,7,0.5,7,36047027800,11214
278,2007,4,25,21,27,33,33,-0.074074,-2,-0.242424,-8,-0.242424,-8,36047027800,11214
278,2007,5,21,25,19,21,21,0.105263,2,0,0,0,0,36047027800,11214
278,2008,0,35,35,26,13,13,0.346154,9,1.692308,22,1.692308,22,36047027800,11214
278,2008,1,30,35,21,27,27,0.428571,9,0.111111,3,0.111111,3,36047027800,11214
278,2008,2,25,30,22,26,26,0.136364,3,-0.038462,-1,-0.038462,-1,36047027800,11214
278,2008,3,26,25,21,29,29,0.238095,5,-0.103448,-3,-0.103448,-3,36047027800,11214
278,2008,4,22,26,25,19,19,-0.12,-3,0.157895,3,0.157895,3,36047027800,11214
278,2008,5,22,22,21,30,30,0.047619,1,-0.266667,-8,-0.266667,-8,36047027800,11214
278,2009,0,32,32,35,19,19,-0.085714,-3,0.684211,13,0.684211,13,36047027800,11214
278,2009,1,34,32,30,25,25,0.133333,4,0.36,9,0.36,9,36047027800,11214
278,2009,2,31,34,25,21,21,0.24,6,0.47619,10,0.47619,10,36047027800,11214
278,2009,3,26,31,26,27,27,0,0,-0.037037,-1,-0.037037,-1,36047027800,11214
278,2009,4,26,26,22,27,27,0.181818,4,-0.037037,-1,-0.037037,-1,36047027800,11214
278,2009,5,24,26,22,19,19,0.090909,2,0.263158,5,0.263158,5,36047027800,11214
278,2010,0,46,46,32,26,26,0.4375,14,0.769231,20,0.769231,20,36047027800,11214
278,2010,1,32,46,34,21,21,-0.058824,-2,0.52381,11,0.52381,11,36047027800,11214
278,2010,2,32,32,31,22,22,0.032258,1,0.454545,10,0.454545,10,36047027800,11214
278,2010,3,27,32,26,21,21,0.038462,1,0.285714,6,0.285714,6,36047027800,11214
278,2010,4,25,27,26,25,25,-0.038462,-1,0,0,0,0,36047027800,11214
278,2010,5,25,25,24,21,21,0.041667,1,0.190476,4,0.190476,4,36047027800,11214
280,2001,0,10,10,10,10,10,0,0,0,0,0,0,36047028000,11214
280,2001,1,13,10,13,13,13,0,0,0,0,0,0,36047028000,11214
280,2001,2,14,13,14,14,14,0,0,0,0,0,0,36047028000,11214
280,2001,3,9,14,9,9,9,0,0,0,0,0,0,36047028000,11214
280,2001,4,11,9,11,11,11,0,0,0,0,0,0,36047028000,11214
280,2001,5,8,11,8,8,8,0,0,0,0,0,0,36047028000,11214
280,2002,0,9,9,10,9,9,-0.1,-1,0,0,0,0,36047028000,11214
280,2002,1,14,9,13,14,14,0.076923,1,0,0,0,0,36047028000,11214
280,2002,2,13,14,14,13,13,-0.071429,-1,0,0,0,0,36047028000,11214
280,2002,3,12,13,9,12,12,0.333333,3,0,0,0,0,36047028000,11214
280,2002,4,7,12,11,7,7,-0.363636,-4,0,0,0,0,36047028000,11214
280,2002,5,11,7,8,11,11,0.375,3,0,0,0,0,36047028000,11214
280,2003,0,16,16,9,16,16,0.777778,7,0,0,0,0,36047028000,11214
280,2003,1,13,16,14,13,13,-0.071429,-1,0,0,0,0,36047028000,11214
280,2003,2,20,13,13,20,20,0.538462,7,0,0,0,0,36047028000,11214
280,2003,3,15,20,12,15,15,0.25,3,0,0,0,0,36047028000,11214
280,2003,4,13,15,7,13,13,0.857143,6,0,0,0,0,36047028000,11214
280,2003,5,7,13,11,7,7,-0.363636,-4,0,0,0,0,36047028000,11214
280,2004,0,11,11,16,10,10,-0.3125,-5,0.1,1,0.1,1,36047028000,11214
280,2004,1,15,11,13,13,13,0.153846,2,0.153846,2,0.153846,2,36047028000,11214
280,2004,2,10,15,20,14,14,-0.5,-10,-0.285714,-4,-0.285714,-4,36047028000,11214
280,2004,3,17,10,15,9,9,0.133333,2,0.888889,8,0.888889,8,36047028000,11214
280,2004,4,10,17,13,11,11,-0.230769,-3,-0.090909,-1,-0.090909,-1,36047028000,11214
280,2004,5,11,10,7,8,8,0.571429,4,0.375,3,0.375,3,36047028000,11214
280,2005,0,12,12,11,9,9,0.090909,1,0.333333,3,0.333333,3,36047028000,11214
280,2005,1,10,12,15,14,14,-0.333333,-5,-0.285714,-4,-0.285714,-4,36047028000,11214
280,2005,2,13,10,10,13,13,0.3,3,0,0,0,0,36047028000,11214
280,2005,3,8,13,17,12,12,-0.529412,-9,-0.333333,-4,-0.333333,-4,36047028000,11214
280,2005,4,16,8,10,7,7,0.6,6,1.285714,9,1.285714,9,36047028000,11214
280,2005,5,10,16,11,11,11,-0.090909,-1,-0.090909,-1,-0.090909,-1,36047028000,11214
280,2006,0,8,8,12,16,16,-0.333333,-4,-0.5,-8,-0.5,-8,36047028000,11214
280,2006,1,11,8,10,13,13,0.1,1,-0.153846,-2,-0.153846,-2,36047028000,11214
280,2006,2,13,11,13,20,20,0,0,-0.35,-7,-0.35,-7,36047028000,11214
280,2006,3,13,13,8,15,15,0.625,5,-0.133333,-2,-0.133333,-2,36047028000,11214
280,2006,4,8,13,16,13,13,-0.5,-8,-0.384615,-5,-0.384615,-5,36047028000,11214
280,2006,5,12,8,10,7,7,0.2,2,0.714286,5,0.714286,5,36047028000,11214
280,2007,0,13,13,8,11,11,0.625,5,0.181818,2,0.181818,2,36047028000,11214
280,2007,1,10,13,11,15,15,-0.090909,-1,-0.333333,-5,-0.333333,-5,36047028000,11214
280,2007,2,10,10,13,10,10,-0.230769,-3,0,0,0,0,36047028000,11214
280,2007,3,12,10,13,17,17,-0.076923,-1,-0.294118,-5,-0.294118,-5,36047028000,11214
280,2007,4,14,12,8,10,10,0.75,6,0.4,4,0.4,4,36047028000,11214
280,2007,5,10,14,12,11,11,-0.166667,-2,-0.090909,-1,-0.090909,-1,36047028000,11214
280,2008,0,13,13,13,12,12,0,0,0.083333,1,0.083333,1,36047028000,11214
280,2008,1,17,13,10,10,10,0.7,7,0.7,7,0.7,7,36047028000,11214
280,2008,2,11,17,10,13,13,0.1,1,-0.153846,-2,-0.153846,-2,36047028000,11214
280,2008,3,11,11,12,8,8,-0.083333,-1,0.375,3,0.375,3,36047028000,11214
280,2008,4,13,11,14,16,16,-0.071429,-1,-0.1875,-3,-0.1875,-3,36047028000,11214
280,2008,5,15,13,10,10,10,0.5,5,0.5,5,0.5,5,36047028000,11214
280,2009,0,20,20,13,8,8,0.538462,7,1.5,12,1.5,12,36047028000,11214
280,2009,1,11,20,17,11,11,-0.352941,-6,0,0,0,0,36047028000,11214
280,2009,2,18,11,11,13,13,0.636364,7,0.384615,5,0.384615,5,36047028000,11214
280,2009,3,13,18,11,13,13,0.181818,2,0,0,0,0,36047028000,11214
280,2009,4,13,13,13,8,8,0,0,0.625,5,0.625,5,36047028000,11214
280,2009,5,10,13,15,12,12,-0.333333,-5,-0.166667,-2,-0.166667,-2,36047028000,11214
280,2010,0,13,13,20,13,13,-0.35,-7,0,0,0,0,36047028000,11214
280,2010,1,16,13,11,10,10,0.454545,5,0.6,6,0.6,6,36047028000,11214
280,2010,2,9,16,18,10,10,-0.5,-9,-0.1,-1,-0.1,-1,36047028000,11214
280,2010,3,16,9,13,12,12,0.230769,3,0.333333,4,0.333333,4,36047028000,11214
280,2010,4,14,16,13,14,14,0.076923,1,0,0,0,0,36047028000,11214
280,2010,5,12,14,10,10,10,0.2,2,0.2,2,0.2,2,36047028000,11214
282,2001,0,31,31,31,31,31,0,0,0,0,0,0,36047028200,11214
282,2001,1,22,31,22,22,22,0,0,0,0,0,0,36047028200,11214
282,2001,2,19,22,19,19,19,0,0,0,0,0,0,36047028200,11214
282,2001,3,20,19,20,20,20,0,0,0,0,0,0,36047028200,11214
282,2001,4,27,20,27,27,27,0,0,0,0,0,0,36047028200,11214
282,2001,5,25,27,25,25,25,0,0,0,0,0,0,36047028200,11214
282,2002,0,27,27,31,27,27,-0.129032,-4,0,0,0,0,36047028200,11214
282,2002,1,36,27,22,36,36,0.636364,14,0,0,0,0,36047028200,11214
282,2002,2,19,36,19,19,19,0,0,0,0,0,0,36047028200,11214
282,2002,3,20,19,20,20,20,0,0,0,0,0,0,36047028200,11214
282,2002,4,17,20,27,17,17,-0.37037,-10,0,0,0,0,36047028200,11214
282,2002,5,25,17,25,25,25,0,0,0,0,0,0,36047028200,11214
282,2003,0,27,27,27,27,27,0,0,0,0,0,0,36047028200,11214
282,2003,1,30,27,36,30,30,-0.166667,-6,0,0,0,0,36047028200,11214
282,2003,2,34,30,19,34,34,0.789474,15,0,0,0,0,36047028200,11214
282,2003,3,14,34,20,14,14,-0.3,-6,0,0,0,0,36047028200,11214
282,2003,4,17,14,17,17,17,0,0,0,0,0,0,36047028200,11214
282,2003,5,15,17,25,15,15,-0.4,-10,0,0,0,0,36047028200,11214
282,2004,0,26,26,27,31,31,-0.037037,-1,-0.16129,-5,-0.16129,-5,36047028200,11214
282,2004,1,25,26,30,22,22,-0.166667,-5,0.136364,3,0.136364,3,36047028200,11214
282,2004,2,29,25,34,19,19,-0.147059,-5,0.526316,10,0.526316,10,36047028200,11214
282,2004,3,32,29,14,20,20,1.285714,18,0.6,12,0.6,12,36047028200,11214
282,2004,4,10,32,17,27,27,-0.411765,-7,-0.62963,-17,-0.62963,-17,36047028200,11214
282,2004,5,16,10,15,25,25,0.066667,1,-0.36,-9,-0.36,-9,36047028200,11214
282,2005,0,31,31,26,27,27,0.192308,5,0.148148,4,0.148148,4,36047028200,11214
282,2005,1,28,31,25,36,36,0.12,3,-0.222222,-8,-0.222222,-8,36047028200,11214
282,2005,2,33,28,29,19,19,0.137931,4,0.736842,14,0.736842,14,36047028200,11214
282,2005,3,23,33,32,20,20,-0.28125,-9,0.15,3,0.15,3,36047028200,11214
282,2005,4,34,23,10,17,17,2.4,24,1,17,1,17,36047028200,11214
282,2005,5,11,34,16,25,25,-0.3125,-5,-0.56,-14,-0.56,-14,36047028200,11214
282,2006,0,20,20,31,27,27,-0.354839,-11,-0.259259,-7,-0.259259,-7,36047028200,11214
282,2006,1,33,20,28,30,30,0.178571,5,0.1,3,0.1,3,36047028200,11214
282,2006,2,29,33,33,34,34,-0.121212,-4,-0.147059,-5,-0.147059,-5,36047028200,11214
282,2006,3,27,29,23,14,14,0.173913,4,0.928571,13,0.928571,13,36047028200,11214
282,2006,4,24,27,34,17,17,-0.294118,-10,0.411765,7,0.411765,7,36047028200,11214
282,2006,5,31,24,11,15,15,1.818182,20,1.066667,16,1.066667,16,36047028200,11214
282,2007,0,27,27,20,26,26,0.35,7,0.038462,1,0.038462,1,36047028200,11214
282,2007,1,23,27,33,25,25,-0.30303,-10,-0.08,-2,-0.08,-2,36047028200,11214
282,2007,2,31,23,29,29,29,0.068966,2,0.068966,2,0.068966,2,36047028200,11214
282,2007,3,27,31,27,32,32,0,0,-0.15625,-5,-0.15625,-5,36047028200,11214
282,2007,4,24,27,24,10,10,0,0,1.4,14,1.4,14,36047028200,11214
282,2007,5,24,24,31,16,16,-0.225806,-7,0.5,8,0.5,8,36047028200,11214
282,2008,0,20,20,27,31,31,-0.259259,-7,-0.354839,-11,-0.354839,-11,36047028200,11214
282,2008,1,33,20,23,28,28,0.434783,10,0.178571,5,0.178571,5,36047028200,11214
282,2008,2,25,33,31,33,33,-0.193548,-6,-0.242424,-8,-0.242424,-8,36047028200,11214
282,2008,3,29,25,27,23,23,0.074074,2,0.26087,6,0.26087,6,36047028200,11214
282,2008,4,23,29,24,34,34,-0.041667,-1,-0.323529,-11,-0.323529,-11,36047028200,11214
282,2008,5,22,23,24,11,11,-0.083333,-2,1,11,1,11,36047028200,11214
282,2009,0,22,22,20,20,20,0.1,2,0.1,2,0.1,2,36047028200,11214
282,2009,1,23,22,33,33,33,-0.30303,-10,-0.30303,-10,-0.30303,-10,36047028200,11214
282,2009,2,37,23,25,29,29,0.48,12,0.275862,8,0.275862,8,36047028200,11214
282,2009,3,30,37,29,27,27,0.034483,1,0.111111,3,0.111111,3,36047028200,11214
282,2009,4,26,30,23,24,24,0.130435,3,0.083333,2,0.083333,2,36047028200,11214
282,2009,5,21,26,22,31,31,-0.045455,-1,-0.322581,-10,-0.322581,-10,36047028200,11214
282,2010,0,25,25,22,27,27,0.136364,3,-0.074074,-2,-0.074074,-2,36047028200,11214
282,2010,1,29,25,23,23,23,0.26087,6,0.26087,6,0.26087,6,36047028200,11214
282,2010,2,20,29,37,31,31,-0.459459,-17,-0.354839,-11,-0.354839,-11,36047028200,11214
282,2010,3,36,20,30,27,27,0.2,6,0.333333,9,0.333333,9,36047028200,11214
282,2010,4,29,36,26,24,24,0.115385,3,0.208333,5,0.208333,5,36047028200,11214
282,2010,5,33,29,21,24,24,0.571429,12,0.375,9,0.375,9,36047028200,11214
284,2001,0,32,32,32,32,32,0,0,0,0,0,0,36047028400,11214
284,2001,1,23,32,23,23,23,0,0,0,0,0,0,36047028400,11214
284,2001,2,38,23,38,38,38,0,0,0,0,0,0,36047028400,11214
284,2001,3,27,38,27,27,27,0,0,0,0,0,0,36047028400,11214
284,2001,4,26,27,26,26,26,0,0,0,0,0,0,36047028400,11214
284,2001,5,31,26,31,31,31,0,0,0,0,0,0,36047028400,11214
284,2002,0,30,30,32,30,30,-0.0625,-2,0,0,0,0,36047028400,11214
284,2002,1,30,30,23,30,30,0.304348,7,0,0,0,0,36047028400,11214
284,2002,2,25,30,38,25,25,-0.342105,-13,0,0,0,0,36047028400,11214
284,2002,3,39,25,27,39,39,0.444444,12,0,0,0,0,36047028400,11214
284,2002,4,31,39,26,31,31,0.192308,5,0,0,0,0,36047028400,11214
284,2002,5,26,31,31,26,26,-0.16129,-5,0,0,0,0,36047028400,11214
284,2003,0,32,32,30,32,32,0.066667,2,0,0,0,0,36047028400,11214
284,2003,1,35,32,30,35,35,0.166667,5,0,0,0,0,36047028400,11214
284,2003,2,26,35,25,26,26,0.04,1,0,0,0,0,36047028400,11214
284,2003,3,26,26,39,26,26,-0.333333,-13,0,0,0,0,36047028400,11214
284,2003,4,34,26,31,34,34,0.096774,3,0,0,0,0,36047028400,11214
284,2003,5,33,34,26,33,33,0.269231,7,0,0,0,0,36047028400,11214
284,2004,0,38,38,32,32,32,0.1875,6,0.1875,6,0.1875,6,36047028400,11214
284,2004,1,35,38,35,23,23,0,0,0.521739,12,0.521739,12,36047028400,11214
284,2004,2,30,35,26,38,38,0.153846,4,-0.210526,-8,-0.210526,-8,36047028400,11214
284,2004,3,28,30,26,27,27,0.076923,2,0.037037,1,0.037037,1,36047028400,11214
284,2004,4,28,28,34,26,26,-0.176471,-6,0.076923,2,0.076923,2,36047028400,11214
284,2004,5,34,28,33,31,31,0.030303,1,0.096774,3,0.096774,3,36047028400,11214
284,2005,0,37,37,38,30,30,-0.026316,-1,0.233333,7,0.233333,7,36047028400,11214
284,2005,1,34,37,35,30,30,-0.028571,-1,0.133333,4,0.133333,4,36047028400,11214
284,2005,2,26,34,30,25,25,-0.133333,-4,0.04,1,0.04,1,36047028400,11214
284,2005,3,34,26,28,39,39,0.214286,6,-0.128205,-5,-0.128205,-5,36047028400,11214
284,2005,4,34,34,28,31,31,0.214286,6,0.096774,3,0.096774,3,36047028400,11214
284,2005,5,28,34,34,26,26,-0.176471,-6,0.076923,2,0.076923,2,36047028400,11214
284,2006,0,33,33,37,32,32,-0.108108,-4,0.03125,1,0.03125,1,36047028400,11214
284,2006,1,44,33,34,35,35,0.294118,10,0.257143,9,0.257143,9,36047028400,11214
284,2006,2,31,44,26,26,26,0.192308,5,0.192308,5,0.192308,5,36047028400,11214
284,2006,3,23,31,34,26,26,-0.323529,-11,-0.115385,-3,-0.115385,-3,36047028400,11214
284,2006,4,31,23,34,34,34,-0.088235,-3,-0.088235,-3,-0.088235,-3,36047028400,11214
284,2006,5,32,31,28,33,33,0.142857,4,-0.030303,-1,-0.030303,-1,36047028400,11214
284,2007,0,34,34,33,38,38,0.030303,1,-0.105263,-4,-0.105263,-4,36047028400,11214
284,2007,1,38,34,44,35,35,-0.136364,-6,0.085714,3,0.085714,3,36047028400,11214
284,2007,2,43,38,31,30,30,0.387097,12,0.433333,13,0.433333,13,36047028400,11214
284,2007,3,30,43,23,28,28,0.304348,7,0.071429,2,0.071429,2,36047028400,11214
284,2007,4,25,30,31,28,28,-0.193548,-6,-0.107143,-3,-0.107143,-3,36047028400,11214
284,2007,5,34,25,32,34,34,0.0625,2,0,0,0,0,36047028400,11214
284,2008,0,38,38,34,37,37,0.117647,4,0.027027,1,0.027027,1,36047028400,11214
284,2008,1,34,38,38,34,34,-0.105263,-4,0,0,0,0,36047028400,11214
284,2008,2,36,34,43,26,26,-0.162791,-7,0.384615,10,0.384615,10,36047028400,11214
284,2008,3,46,36,30,34,34,0.533333,16,0.352941,12,0.352941,12,36047028400,11214
284,2008,4,29,46,25,34,34,0.16,4,-0.147059,-5,-0.147059,-5,36047028400,11214
284,2008,5,25,29,34,28,28,-0.264706,-9,-0.107143,-3,-0.107143,-3,36047028400,11214
284,2009,0,40,40,38,33,33,0.052632,2,0.212121,7,0.212121,7,36047028400,11214
284,2009,1,46,40,34,44,44,0.352941,12,0.045455,2,0.045455,2,36047028400,11214
284,2009,2,33,46,36,31,31,-0.083333,-3,0.064516,2,0.064516,2,36047028400,11214
284,2009,3,35,33,46,23,23,-0.23913,-11,0.521739,12,0.521739,12,36047028400,11214
284,2009,4,48,35,29,31,31,0.655172,19,0.548387,17,0.548387,17,36047028400,11214
284,2009,5,32,48,25,32,32,0.28,7,0,0,0,0,36047028400,11214
284,2010,0,49,49,40,34,34,0.225,9,0.441176,15,0.441176,15,36047028400,11214
284,2010,1,47,49,46,38,38,0.021739,1,0.236842,9,0.236842,9,36047028400,11214
284,2010,2,45,47,33,43,43,0.363636,12,0.046512,2,0.046512,2,36047028400,11214
284,2010,3,31,45,35,30,30,-0.114286,-4,0.033333,1,0.033333,1,36047028400,11214
284,2010,4,45,31,48,25,25,-0.0625,-3,0.8,20,0.8,20,36047028400,11214
284,2010,5,47,45,32,34,34,0.46875,15,0.382353,13,0.382353,13,36047028400,11214
286,2001,0,51,51,51,51,51,0,0,0,0,0,0,36047028600,11214
286,2001,1,51,51,51,51,51,0,0,0,0,0,0,36047028600,11214
286,2001,2,58,51,58,58,58,0,0,0,0,0,0,36047028600,11214
286,2001,3,39,58,39,39,39,0,0,0,0,0,0,36047028600,11214
286,2001,4,46,39,46,46,46,0,0,0,0,0,0,36047028600,11214
286,2001,5,45,46,45,45,45,0,0,0,0,0,0,36047028600,11214
286,2002,0,53,53,51,53,53,0.039216,2,0,0,0,0,36047028600,11214
286,2002,1,55,53,51,55,55,0.078431,4,0,0,0,0,36047028600,11214
286,2002,2,46,55,58,46,46,-0.206897,-12,0,0,0,0,36047028600,11214
286,2002,3,57,46,39,57,57,0.461538,18,0,0,0,0,36047028600,11214
286,2002,4,43,57,46,43,43,-0.065217,-3,0,0,0,0,36047028600,11214
286,2002,5,46,43,45,46,46,0.022222,1,0,0,0,0,36047028600,11214
286,2003,0,60,60,53,60,60,0.132075,7,0,0,0,0,36047028600,11214
286,2003,1,54,60,55,54,54,-0.018182,-1,0,0,0,0,36047028600,11214
286,2003,2,51,54,46,51,51,0.108696,5,0,0,0,0,36047028600,11214
286,2003,3,51,51,57,51,51,-0.105263,-6,0,0,0,0,36047028600,11214
286,2003,4,49,51,43,49,49,0.139535,6,0,0,0,0,36047028600,11214
286,2003,5,42,49,46,42,42,-0.086957,-4,0,0,0,0,36047028600,11214
286,2004,0,57,57,60,51,51,-0.05,-3,0.117647,6,0.117647,6,36047028600,11214
286,2004,1,68,57,54,51,51,0.259259,14,0.333333,17,0.333333,17,36047028600,11214
286,2004,2,51,68,51,58,58,0,0,-0.12069,-7,-0.12069,-7,36047028600,11214
286,2004,3,49,51,51,39,39,-0.039216,-2,0.25641,10,0.25641,10,36047028600,11214
286,2004,4,44,49,49,46,46,-0.102041,-5,-0.043478,-2,-0.043478,-2,36047028600,11214
286,2004,5,42,44,42,45,45,0,0,-0.066667,-3,-0.066667,-3,36047028600,11214
286,2005,0,56,56,57,53,53,-0.017544,-1,0.056604,3,0.056604,3,36047028600,11214
286,2005,1,57,56,68,55,55,-0.161765,-11,0.036364,2,0.036364,2,36047028600,11214
286,2005,2,63,57,51,46,46,0.235294,12,0.369565,17,0.369565,17,36047028600,11214
286,2005,3,40,63,49,57,57,-0.183673,-9,-0.298246,-17,-0.298246,-17,36047028600,11214
286,2005,4,47,40,44,43,43,0.068182,3,0.093023,4,0.093023,4,36047028600,11214
286,2005,5,39,47,42,46,46,-0.071429,-3,-0.152174,-7,-0.152174,-7,36047028600,11214
286,2006,0,43,43,56,60,60,-0.232143,-13,-0.283333,-17,-0.283333,-17,36047028600,11214
286,2006,1,57,43,57,54,54,0,0,0.055556,3,0.055556,3,36047028600,11214
286,2006,2,57,57,63,51,51,-0.095238,-6,0.117647,6,0.117647,6,36047028600,11214
286,2006,3,58,57,40,51,51,0.45,18,0.137255,7,0.137255,7,36047028600,11214
286,2006,4,34,58,47,49,49,-0.276596,-13,-0.306122,-15,-0.306122,-15,36047028600,11214
286,2006,5,43,34,39,42,42,0.102564,4,0.02381,1,0.02381,1,36047028600,11214
286,2007,0,62,62,43,57,57,0.44186,19,0.087719,5,0.087719,5,36047028600,11214
286,2007,1,47,62,57,68,68,-0.175439,-10,-0.308824,-21,-0.308824,-21,36047028600,11214
286,2007,2,50,47,57,51,51,-0.122807,-7,-0.019608,-1,-0.019608,-1,36047028600,11214
286,2007,3,58,50,58,49,49,0,0,0.183673,9,0.183673,9,36047028600,11214
286,2007,4,55,58,34,44,44,0.617647,21,0.25,11,0.25,11,36047028600,11214
286,2007,5,34,55,43,42,42,-0.209302,-9,-0.190476,-8,-0.190476,-8,36047028600,11214
286,2008,0,30,30,62,56,56,-0.516129,-32,-0.464286,-26,-0.464286,-26,36047028600,11214
286,2008,1,65,30,47,57,57,0.382979,18,0.140351,8,0.140351,8,36047028600,11214
286,2008,2,48,65,50,63,63,-0.04,-2,-0.238095,-15,-0.238095,-15,36047028600,11214
286,2008,3,53,48,58,40,40,-0.086207,-5,0.325,13,0.325,13,36047028600,11214
286,2008,4,52,53,55,47,47,-0.054545,-3,0.106383,5,0.106383,5,36047028600,11214
286,2008,5,52,52,34,39,39,0.529412,18,0.333333,13,0.333333,13,36047028600,11214
286,2009,0,59,59,30,43,43,0.966667,29,0.372093,16,0.372093,16,36047028600,11214
286,2009,1,41,59,65,57,57,-0.369231,-24,-0.280702,-16,-0.280702,-16,36047028600,11214
286,2009,2,70,41,48,57,57,0.458333,22,0.22807,13,0.22807,13,36047028600,11214
286,2009,3,49,70,53,58,58,-0.075472,-4,-0.155172,-9,-0.155172,-9,36047028600,11214
286,2009,4,59,49,52,34,34,0.134615,7,0.735294,25,0.735294,25,36047028600,11214
286,2009,5,45,59,52,43,43,-0.134615,-7,0.046512,2,0.046512,2,36047028600,11214
286,2010,0,53,53,59,62,62,-0.101695,-6,-0.145161,-9,-0.145161,-9,36047028600,11214
286,2010,1,63,53,41,47,47,0.536585,22,0.340426,16,0.340426,16,36047028600,11214
286,2010,2,46,63,70,50,50,-0.342857,-24,-0.08,-4,-0.08,-4,36047028600,11214
286,2010,3,64,46,49,58,58,0.306122,15,0.103448,6,0.103448,6,36047028600,11214
286,2010,4,59,64,59,55,55,0,0,0.072727,4,0.072727,4,36047028600,11214
286,2010,5,55,59,45,34,34,0.222222,10,0.617647,21,0.617647,21,36047028600,11214
288,2001,0,17,17,17,17,17,0,0,0,0,0,0,36047028800,11214
288,2001,1,16,17,16,16,16,0,0,0,0,0,0,36047028800,11214
288,2001,2,9,16,9,9,9,0,0,0,0,0,0,36047028800,11214
288,2001,3,9,9,9,9,9,0,0,0,0,0,0,36047028800,11214
288,2001,4,11,9,11,11,11,0,0,0,0,0,0,36047028800,11214
288,2001,5,12,11,12,12,12,0,0,0,0,0,0,36047028800,11214
288,2002,0,20,20,17,20,20,0.176471,3,0,0,0,0,36047028800,11214
288,2002,1,20,20,16,20,20,0.25,4,0,0,0,0,36047028800,11214
288,2002,2,15,20,9,15,15,0.666667,6,0,0,0,0,36047028800,11214
288,2002,3,10,15,9,10,10,0.111111,1,0,0,0,0,36047028800,11214
288,2002,4,8,10,11,8,8,-0.272727,-3,0,0,0,0,36047028800,11214
288,2002,5,15,8,12,15,15,0.25,3,0,0,0,0,36047028800,11214
288,2003,0,13,13,20,13,13,-0.35,-7,0,0,0,0,36047028800,11214
288,2003,1,21,13,20,21,21,0.05,1,0,0,0,0,36047028800,11214
288,2003,2,20,21,15,20,20,0.333333,5,0,0,0,0,36047028800,11214
288,2003,3,16,20,10,16,16,0.6,6,0,0,0,0,36047028800,11214
288,2003,4,11,16,8,11,11,0.375,3,0,0,0,0,36047028800,11214
288,2003,5,9,11,15,9,9,-0.4,-6,0,0,0,0,36047028800,11214
288,2004,0,12,12,13,17,17,-0.076923,-1,-0.294118,-5,-0.294118,-5,36047028800,11214
288,2004,1,9,12,21,16,16,-0.571429,-12,-0.4375,-7,-0.4375,-7,36047028800,11214
288,2004,2,22,9,20,9,9,0.1,2,1.444444,13,1.444444,13,36047028800,11214
288,2004,3,18,22,16,9,9,0.125,2,1,9,1,9,36047028800,11214
288,2004,4,19,18,11,11,11,0.727273,8,0.727273,8,0.727273,8,36047028800,11214
288,2004,5,10,19,9,12,12,0.111111,1,-0.166667,-2,-0.166667,-2,36047028800,11214
288,2005,0,11,11,12,20,20,-0.083333,-1,-0.45,-9,-0.45,-9,36047028800,11214
288,2005,1,16,11,9,20,20,0.777778,7,-0.2,-4,-0.2,-4,36047028800,11214
288,2005,2,9,16,22,15,15,-0.590909,-13,-0.4,-6,-0.4,-6,36047028800,11214
288,2005,3,23,9,18,10,10,0.277778,5,1.3,13,1.3,13,36047028800,11214
288,2005,4,19,23,19,8,8,0,0,1.375,11,1.375,11,36047028800,11214
288,2005,5,20,19,10,15,15,1,10,0.333333,5,0.333333,5,36047028800,11214
288,2006,0,15,15,11,13,13,0.363636,4,0.153846,2,0.153846,2,36047028800,11214
288,2006,1,15,15,16,21,21,-0.0625,-1,-0.285714,-6,-0.285714,-6,36047028800,11214
288,2006,2,14,15,9,20,20,0.555556,5,-0.3,-6,-0.3,-6,36047028800,11214
288,2006,3,8,14,23,16,16,-0.652174,-15,-0.5,-8,-0.5,-8,36047028800,11214
288,2006,4,20,8,19,11,11,0.052632,1,0.818182,9,0.818182,9,36047028800,11214
288,2006,5,19,20,20,9,9,-0.05,-1,1.111111,10,1.111111,10,36047028800,11214
288,2007,0,17,17,15,12,12,0.133333,2,0.416667,5,0.416667,5,36047028800,11214
288,2007,1,12,17,15,9,9,-0.2,-3,0.333333,3,0.333333,3,36047028800,11214
288,2007,2,17,12,14,22,22,0.214286,3,-0.227273,-5,-0.227273,-5,36047028800,11214
288,2007,3,9,17,8,18,18,0.125,1,-0.5,-9,-0.5,-9,36047028800,11214
288,2007,4,8,9,20,19,19,-0.6,-12,-0.578947,-11,-0.578947,-11,36047028800,11214
288,2007,5,20,8,19,10,10,0.052632,1,1,10,1,10,36047028800,11214
288,2008,0,18,18,17,11,11,0.058824,1,0.636364,7,0.636364,7,36047028800,11214
288,2008,1,17,18,12,16,16,0.416667,5,0.0625,1,0.0625,1,36047028800,11214
288,2008,2,13,17,17,9,9,-0.235294,-4,0.444444,4,0.444444,4,36047028800,11214
288,2008,3,15,13,9,23,23,0.666667,6,-0.347826,-8,-0.347826,-8,36047028800,11214
288,2008,4,12,15,8,19,19,0.5,4,-0.368421,-7,-0.368421,-7,36047028800,11214
288,2008,5,11,12,20,20,20,-0.45,-9,-0.45,-9,-0.45,-9,36047028800,11214
288,2009,0,8,8,18,15,15,-0.555556,-10,-0.466667,-7,-0.466667,-7,36047028800,11214
288,2009,1,23,8,17,15,15,0.352941,6,0.533333,8,0.533333,8,36047028800,11214
288,2009,2,18,23,13,14,14,0.384615,5,0.285714,4,0.285714,4,36047028800,11214
288,2009,3,15,18,15,8,8,0,0,0.875,7,0.875,7,36047028800,11214
288,2009,4,14,15,12,20,20,0.166667,2,-0.3,-6,-0.3,-6,36047028800,11214
288,2009,5,11,14,11,19,19,0,0,-0.421053,-8,-0.421053,-8,36047028800,11214
288,2010,0,19,19,8,17,17,1.375,11,0.117647,2,0.117647,2,36047028800,11214
288,2010,1,12,19,23,12,12,-0.478261,-11,0,0,0,0,36047028800,11214
288,2010,2,23,12,18,17,17,0.277778,5,0.352941,6,0.352941,6,36047028800,11214
288,2010,3,14,23,15,9,9,-0.066667,-1,0.555556,5,0.555556,5,36047028800,11214
288,2010,4,16,14,14,8,8,0.142857,2,1,8,1,8,36047028800,11214
288,2010,5,14,16,11,20,20,0.272727,3,-0.3,-6,-0.3,-6,36047028800,11214
290,2001,0,6,6,6,6,6,0,0,0,0,0,0,36047029000,11214
290,2001,1,7,6,7,7,7,0,0,0,0,0,0,36047029000,11214
290,2001,2,5,7,5,5,5,0,0,0,0,0,0,36047029000,11214
290,2001,3,10,5,10,10,10,0,0,0,0,0,0,36047029000,11214
290,2001,4,7,10,7,7,7,0,0,0,0,0,0,36047029000,11214
290,2001,5,9,7,9,9,9,0,0,0,0,0,0,36047029000,11214
290,2002,0,8,8,6,8,8,0.333333,2,0,0,0,0,36047029000,11214
290,2002,1,10,8,7,10,10,0.428571,3,0,0,0,0,36047029000,11214
290,2002,2,6,10,5,6,6,0.2,1,0,0,0,0,36047029000,11214
290,2002,3,5,6,10,5,5,-0.5,-5,0,0,0,0,36047029000,11214
290,2002,4,10,5,7,10,10,0.428571,3,0,0,0,0,36047029000,11214
290,2002,5,7,10,9,7,7,-0.222222,-2,0,0,0,0,36047029000,11214
290,2003,0,6,6,8,6,6,-0.25,-2,0,0,0,0,36047029000,11214
290,2003,1,11,6,10,11,11,0.1,1,0,0,0,0,36047029000,11214
290,2003,2,9,11,6,9,9,0.5,3,0,0,0,0,36047029000,11214
290,2003,3,10,9,5,10,10,1,5,0,0,0,0,36047029000,11214
290,2003,4,7,10,10,7,7,-0.3,-3,0,0,0,0,36047029000,11214
290,2003,5,10,7,7,10,10,0.428571,3,0,0,0,0,36047029000,11214
290,2004,0,13,13,6,6,6,1.166667,7,1.166667,7,1.166667,7,36047029000,11214
290,2004,1,5,13,11,7,7,-0.545455,-6,-0.285714,-2,-0.285714,-2,36047029000,11214
290,2004,2,11,5,9,5,5,0.222222,2,1.2,6,1.2,6,36047029000,11214
290,2004,3,8,11,10,10,10,-0.2,-2,-0.2,-2,-0.2,-2,36047029000,11214
290,2004,4,7,8,7,7,7,0,0,0,0,0,0,36047029000,11214
290,2004,5,7,7,10,9,9,-0.3,-3,-0.222222,-2,-0.222222,-2,36047029000,11214
290,2005,0,6,6,13,8,8,-0.538462,-7,-0.25,-2,-0.25,-2,36047029000,11214
290,2005,1,11,6,5,10,10,1.2,6,0.1,1,0.1,1,36047029000,11214
290,2005,2,6,11,11,6,6,-0.454545,-5,0,0,0,0,36047029000,11214
290,2005,3,6,6,8,5,5,-0.25,-2,0.2,1,0.2,1,36047029000,11214
290,2005,4,8,6,7,10,10,0.142857,1,-0.2,-2,-0.2,-2,36047029000,11214
290,2005,5,7,8,7,7,7,0,0,0,0,0,0,36047029000,11214
290,2006,0,15,15,6,6,6,1.5,9,1.5,9,1.5,9,36047029000,11214
290,2006,1,8,15,11,11,11,-0.272727,-3,-0.272727,-3,-0.272727,-3,36047029000,11214
290,2006,2,7,8,6,9,9,0.166667,1,-0.222222,-2,-0.222222,-2,36047029000,11214
290,2006,3,8,7,6,10,10,0.333333,2,-0.2,-2,-0.2,-2,36047029000,11214
290,2006,4,7,8,8,7,7,-0.125,-1,0,0,0,0,36047029000,11214
290,2006,5,5,7,7,10,10,-0.285714,-2,-0.5,-5,-0.5,-5,36047029000,11214
290,2007,0,14,14,15,13,13,-0.066667,-1,0.076923,1,0.076923,1,36047029000,11214
290,2007,1,16,14,8,5,5,1,8,2.2,11,2.2,11,36047029000,11214
290,2007,2,7,16,7,11,11,0,0,-0.363636,-4,-0.363636,-4,36047029000,11214
290,2007,3,9,7,8,8,8,0.125,1,0.125,1,0.125,1,36047029000,11214
290,2007,4,10,9,7,7,7,0.428571,3,0.428571,3,0.428571,3,36047029000,11214
290,2007,5,6,10,5,7,7,0.2,1,-0.142857,-1,-0.142857,-1,36047029000,11214
290,2008,0,6,6,14,6,6,-0.571429,-8,0,0,0,0,36047029000,11214
290,2008,1,14,6,16,11,11,-0.125,-2,0.272727,3,0.272727,3,36047029000,11214
290,2008,2,13,14,7,6,6,0.857143,6,1.166667,7,1.166667,7,36047029000,11214
290,2008,3,7,13,9,6,6,-0.222222,-2,0.166667,1,0.166667,1,36047029000,11214
290,2008,4,8,7,10,8,8,-0.2,-2,0,0,0,0,36047029000,11214
290,2008,5,10,8,6,7,7,0.666667,4,0.428571,3,0.428571,3,36047029000,11214
290,2009,0,12,12,6,15,15,1,6,-0.2,-3,-0.2,-3,36047029000,11214
290,2009,1,8,12,14,8,8,-0.428571,-6,0,0,0,0,36047029000,11214
290,2009,2,14,8,13,7,7,0.076923,1,1,7,1,7,36047029000,11214
290,2009,3,12,14,7,8,8,0.714286,5,0.5,4,0.5,4,36047029000,11214
290,2009,4,5,12,8,7,7,-0.375,-3,-0.285714,-2,-0.285714,-2,36047029000,11214
290,2009,5,5,5,10,5,5,-0.5,-5,0,0,0,0,36047029000,11214
290,2010,0,15,15,12,14,14,0.25,3,0.071429,1,0.071429,1,36047029000,11214
290,2010,1,16,15,8,16,16,1,8,0,0,0,0,36047029000,11214
290,2010,2,8,16,14,7,7,-0.428571,-6,0.142857,1,0.142857,1,36047029000,11214
290,2010,3,13,8,12,9,9,0.083333,1,0.444444,4,0.444444,4,36047029000,11214
290,2010,4,12,13,5,10,10,1.4,7,0.2,2,0.2,2,36047029000,11214
290,2010,5,4,12,5,6,6,-0.2,-1,-0.333333,-2,-0.333333,-2,36047029000,11214
292,2001,0,26,26,26,26,26,0,0,0,0,0,0,36047029200,11214
292,2001,1,16,26,16,16,16,0,0,0,0,0,0,36047029200,11214
292,2001,2,29,16,29,29,29,0,0,0,0,0,0,36047029200,11214
292,2001,3,24,29,24,24,24,0,0,0,0,0,0,36047029200,11214
292,2001,4,26,24,26,26,26,0,0,0,0,0,0,36047029200,11214
292,2001,5,24,26,24,24,24,0,0,0,0,0,0,36047029200,11214
292,2002,0,24,24,26,24,24,-0.076923,-2,0,0,0,0,36047029200,11214
292,2002,1,27,24,16,27,27,0.6875,11,0,0,0,0,36047029200,11214
292,2002,2,16,27,29,16,16,-0.448276,-13,0,0,0,0,36047029200,11214
292,2002,3,26,16,24,26,26,0.083333,2,0,0,0,0,36047029200,11214
292,2002,4,25,26,26,25,25,-0.038462,-1,0,0,0,0,36047029200,11214
292,2002,5,26,25,24,26,26,0.083333,2,0,0,0,0,36047029200,11214
292,2003,0,22,22,24,22,22,-0.083333,-2,0,0,0,0,36047029200,11214
292,2003,1,29,22,27,29,29,0.074074,2,0,0,0,0,36047029200,11214
292,2003,2,23,29,16,23,23,0.4375,7,0,0,0,0,36047029200,11214
292,2003,3,18,23,26,18,18,-0.307692,-8,0,0,0,0,36047029200,11214
292,2003,4,23,18,25,23,23,-0.08,-2,0,0,0,0,36047029200,11214
292,2003,5,27,23,26,27,27,0.038462,1,0,0,0,0,36047029200,11214
292,2004,0,27,27,22,26,26,0.227273,5,0.038462,1,0.038462,1,36047029200,11214
292,2004,1,26,27,29,16,16,-0.103448,-3,0.625,10,0.625,10,36047029200,11214
292,2004,2,26,26,23,29,29,0.130435,3,-0.103448,-3,-0.103448,-3,36047029200,11214
292,2004,3,21,26,18,24,24,0.166667,3,-0.125,-3,-0.125,-3,36047029200,11214
292,2004,4,17,21,23,26,26,-0.26087,-6,-0.346154,-9,-0.346154,-9,36047029200,11214
292,2004,5,24,17,27,24,24,-0.111111,-3,0,0,0,0,36047029200,11214
292,2005,0,29,29,27,24,24,0.074074,2,0.208333,5,0.208333,5,36047029200,11214
292,2005,1,26,29,26,27,27,0,0,-0.037037,-1,-0.037037,-1,36047029200,11214
292,2005,2,27,26,26,16,16,0.038462,1,0.6875,11,0.6875,11,36047029200,11214
292,2005,3,27,27,21,26,26,0.285714,6,0.038462,1,0.038462,1,36047029200,11214
292,2005,4,19,27,17,25,25,0.117647,2,-0.24,-6,-0.24,-6,36047029200,11214
292,2005,5,15,19,24,26,26,-0.375,-9,-0.423077,-11,-0.423077,-11,36047029200,11214
292,2006,0,23,23,29,22,22,-0.206897,-6,0.045455,1,0.045455,1,36047029200,11214
292,2006,1,33,23,26,29,29,0.269231,7,0.137931,4,0.137931,4,36047029200,11214
292,2006,2,23,33,27,23,23,-0.148148,-4,0,0,0,0,36047029200,11214
292,2006,3,27,23,27,18,18,0,0,0.5,9,0.5,9,36047029200,11214
292,2006,4,22,27,19,23,23,0.157895,3,-0.043478,-1,-0.043478,-1,36047029200,11214
292,2006,5,17,22,15,27,27,0.133333,2,-0.37037,-10,-0.37037,-10,36047029200,11214
292,2007,0,17,17,23,27,27,-0.26087,-6,-0.37037,-10,-0.37037,-10,36047029200,11214
292,2007,1,26,17,33,26,26,-0.212121,-7,0,0,0,0,36047029200,11214
292,2007,2,26,26,23,26,26,0.130435,3,0,0,0,0,36047029200,11214
292,2007,3,20,26,27,21,21,-0.259259,-7,-0.047619,-1,-0.047619,-1,36047029200,11214
292,2007,4,24,20,22,17,17,0.090909,2,0.411765,7,0.411765,7,36047029200,11214
292,2007,5,23,24,17,24,24,0.352941,6,-0.041667,-1,-0.041667,-1,36047029200,11214
292,2008,0,25,25,17,29,29,0.470588,8,-0.137931,-4,-0.137931,-4,36047029200,11214
292,2008,1,21,25,26,26,26,-0.192308,-5,-0.192308,-5,-0.192308,-5,36047029200,11214
292,2008,2,28,21,26,27,27,0.076923,2,0.037037,1,0.037037,1,36047029200,11214
292,2008,3,22,28,20,27,27,0.1,2,-0.185185,-5,-0.185185,-5,36047029200,11214
292,2008,4,21,22,24,19,19,-0.125,-3,0.105263,2,0.105263,2,36047029200,11214
292,2008,5,22,21,23,15,15,-0.043478,-1,0.466667,7,0.466667,7,36047029200,11214
292,2009,0,25,25,25,23,23,0,0,0.086957,2,0.086957,2,36047029200,11214
292,2009,1,31,25,21,33,33,0.47619,10,-0.060606,-2,-0.060606,-2,36047029200,11214
292,2009,2,23,31,28,23,23,-0.178571,-5,0,0,0,0,36047029200,11214
292,2009,3,27,23,22,27,27,0.227273,5,0,0,0,0,36047029200,11214
292,2009,4,22,27,21,22,22,0.047619,1,0,0,0,0,36047029200,11214
292,2009,5,26,22,22,17,17,0.181818,4,0.529412,9,0.529412,9,36047029200,11214
292,2010,0,26,26,25,17,17,0.04,1,0.529412,9,0.529412,9,36047029200,11214
292,2010,1,28,26,31,26,26,-0.096774,-3,0.076923,2,0.076923,2,36047029200,11214
292,2010,2,33,28,23,26,26,0.434783,10,0.269231,7,0.269231,7,36047029200,11214
292,2010,3,22,33,27,20,20,-0.185185,-5,0.1,2,0.1,2,36047029200,11214
292,2010,4,25,22,22,24,24,0.136364,3,0.041667,1,0.041667,1,36047029200,11214
292,2010,5,21,25,26,23,23,-0.192308,-5,-0.086957,-2,-0.086957,-2,36047029200,11214
294,2001,0,5,5,5,5,5,0,0,0,0,0,0,36047029400,11214
294,2001,1,14,5,14,14,14,0,0,0,0,0,0,36047029400,11214
294,2001,2,3,14,3,3,3,0,0,0,0,0,0,36047029400,11214
294,2001,3,17,3,17,17,17,0,0,0,0,0,0,36047029400,11214
294,2001,4,10,17,10,10,10,0,0,0,0,0,0,36047029400,11214
294,2001,5,7,10,7,7,7,0,0,0,0,0,0,36047029400,11214
294,2002,0,6,6,5,6,6,0.2,1,0,0,0,0,36047029400,11214
294,2002,1,6,6,14,6,6,-0.571429,-8,0,0,0,0,36047029400,11214
294,2002,2,14,6,3,14,14,3.666667,11,0,0,0,0,36047029400,11214
294,2002,3,5,14,17,5,5,-0.705882,-12,0,0,0,0,36047029400,11214
294,2002,4,18,5,10,18,18,0.8,8,0,0,0,0,36047029400,11214
294,2002,5,10,18,7,10,10,0.428571,3,0,0,0,0,36047029400,11214
294,2003,0,10,10,6,10,10,0.666667,4,0,0,0,0,36047029400,11214
294,2003,1,6,10,6,6,6,0,0,0,0,0,0,36047029400,11214
294,2003,2,8,6,14,8,8,-0.428571,-6,0,0,0,0,36047029400,11214
294,2003,3,10,8,5,10,10,1,5,0,0,0,0,36047029400,11214
294,2003,4,5,10,18,5,5,-0.722222,-13,0,0,0,0,36047029400,11214
294,2003,5,19,5,10,19,19,0.9,9,0,0,0,0,36047029400,11214
294,2004,0,6,6,10,5,5,-0.4,-4,0.2,1,0.2,1,36047029400,11214
294,2004,1,11,6,6,14,14,0.833333,5,-0.214286,-3,-0.214286,-3,36047029400,11214
294,2004,2,4,11,8,3,3,-0.5,-4,0.333333,1,0.333333,1,36047029400,11214
294,2004,3,10,4,10,17,17,0,0,-0.411765,-7,-0.411765,-7,36047029400,11214
294,2004,4,8,10,5,10,10,0.6,3,-0.2,-2,-0.2,-2,36047029400,11214
294,2004,5,6,8,19,7,7,-0.684211,-13,-0.142857,-1,-0.142857,-1,36047029400,11214
294,2005,0,4,4,6,6,6,-0.333333,-2,-0.333333,-2,-0.333333,-2,36047029400,11214
294,2005,1,9,4,11,6,6,-0.181818,-2,0.5,3,0.5,3,36047029400,11214
294,2005,2,11,9,4,14,14,1.75,7,-0.214286,-3,-0.214286,-3,36047029400,11214
294,2005,3,7,11,10,5,5,-0.3,-3,0.4,2,0.4,2,36047029400,11214
294,2005,4,9,7,8,18,18,0.125,1,-0.5,-9,-0.5,-9,36047029400,11214
294,2005,5,9,9,6,10,10,0.5,3,-0.1,-1,-0.1,-1,36047029400,11214
294,2006,0,10,10,4,10,10,1.5,6,0,0,0,0,36047029400,11214
294,2006,1,4,10,9,6,6,-0.555556,-5,-0.333333,-2,-0.333333,-2,36047029400,11214
294,2006,2,7,4,11,8,8,-0.363636,-4,-0.125,-1,-0.125,-1,36047029400,11214
294,2006,3,10,7,7,10,10,0.428571,3,0,0,0,0,36047029400,11214
294,2006,4,9,10,9,5,5,0,0,0.8,4,0.8,4,36047029400,11214
294,2006,5,12,9,9,19,19,0.333333,3,-0.368421,-7,-0.368421,-7,36047029400,11214
294,2007,0,6,6,10,6,6,-0.4,-4,0,0,0,0,36047029400,11214
294,2007,1,8,6,4,11,11,1,4,-0.272727,-3,-0.272727,-3,36047029400,11214
294,2007,2,4,8,7,4,4,-0.428571,-3,0,0,0,0,36047029400,11214
294,2007,3,4,4,10,10,10,-0.6,-6,-0.6,-6,-0.6,-6,36047029400,11214
294,2007,4,9,4,9,8,8,0,0,0.125,1,0.125,1,36047029400,11214
294,2007,5,11,9,12,6,6,-0.083333,-1,0.833333,5,0.833333,5,36047029400,11214
294,2008,0,7,7,6,4,4,0.166667,1,0.75,3,0.75,3,36047029400,11214
294,2008,1,7,7,8,9,9,-0.125,-1,-0.222222,-2,-0.222222,-2,36047029400,11214
294,2008,2,10,7,4,11,11,1.5,6,-0.090909,-1,-0.090909,-1,36047029400,11214
294,2008,3,4,10,4,7,7,0,0,-0.428571,-3,-0.428571,-3,36047029400,11214
294,2008,4,3,4,9,9,9,-0.666667,-6,-0.666667,-6,-0.666667,-6,36047029400,11214
294,2008,5,10,3,11,9,9,-0.090909,-1,0.111111,1,0.111111,1,36047029400,11214
294,2009,0,6,6,7,10,10,-0.142857,-1,-0.4,-4,-0.4,-4,36047029400,11214
294,2009,1,7,6,7,4,4,0,0,0.75,3,0.75,3,36047029400,11214
294,2009,2,6,7,10,7,7,-0.4,-4,-0.142857,-1,-0.142857,-1,36047029400,11214
294,2009,3,9,6,4,10,10,1.25,5,-0.1,-1,-0.1,-1,36047029400,11214
294,2009,4,3,9,3,9,9,0,0,-0.666667,-6,-0.666667,-6,36047029400,11214
294,2009,5,3,3,10,12,12,-0.7,-7,-0.75,-9,-0.75,-9,36047029400,11214
294,2010,0,13,13,6,6,6,1.166667,7,1.166667,7,1.166667,7,36047029400,11214
294,2010,1,5,13,7,8,8,-0.285714,-2,-0.375,-3,-0.375,-3,36047029400,11214
294,2010,2,5,5,6,4,4,-0.166667,-1,0.25,1,0.25,1,36047029400,11214
294,2010,3,6,5,9,4,4,-0.333333,-3,0.5,2,0.5,2,36047029400,11214
294,2010,4,9,6,3,9,9,2,6,0,0,0,0,36047029400,11214
294,2010,5,3,9,3,11,11,0,0,-0.727273,-8,-0.727273,-8,36047029400,11214
296,2001,0,7,7,7,7,7,0,0,0,0,0,0,36047029600,11214
296,2001,1,12,7,12,12,12,0,0,0,0,0,0,36047029600,11214
296,2001,2,14,12,14,14,14,0,0,0,0,0,0,36047029600,11214
296,2001,3,13,14,13,13,13,0,0,0,0,0,0,36047029600,11214
296,2001,4,9,13,9,9,9,0,0,0,0,0,0,36047029600,11214
296,2001,5,11,9,11,11,11,0,0,0,0,0,0,36047029600,11214
296,2002,0,10,10,7,10,10,0.428571,3,0,0,0,0,36047029600,11214
296,2002,1,8,10,12,8,8,-0.333333,-4,0,0,0,0,36047029600,11214
296,2002,2,8,8,14,8,8,-0.428571,-6,0,0,0,0,36047029600,11214
296,2002,3,9,8,13,9,9,-0.307692,-4,0,0,0,0,36047029600,11214
296,2002,4,8,9,9,8,8,-0.111111,-1,0,0,0,0,36047029600,11214
296,2002,5,10,8,11,10,10,-0.090909,-1,0,0,0,0,36047029600,11214
296,2003,0,13,13,10,13,13,0.3,3,0,0,0,0,36047029600,11214
296,2003,1,10,13,8,10,10,0.25,2,0,0,0,0,36047029600,11214
296,2003,2,10,10,8,10,10,0.25,2,0,0,0,0,36047029600,11214
296,2003,3,9,10,9,9,9,0,0,0,0,0,0,36047029600,11214
296,2003,4,11,9,8,11,11,0.375,3,0,0,0,0,36047029600,11214
296,2003,5,9,11,10,9,9,-0.1,-1,0,0,0,0,36047029600,11214
296,2004,0,11,11,13,7,7,-0.153846,-2,0.571429,4,0.571429,4,36047029600,11214
296,2004,1,16,11,10,12,12,0.6,6,0.333333,4,0.333333,4,36047029600,11214
296,2004,2,8,16,10,14,14,-0.2,-2,-0.428571,-6,-0.428571,-6,36047029600,11214
296,2004,3,8,8,9,13,13,-0.111111,-1,-0.384615,-5,-0.384615,-5,36047029600,11214
296,2004,4,12,8,11,9,9,0.090909,1,0.333333,3,0.333333,3,36047029600,11214
296,2004,5,12,12,9,11,11,0.333333,3,0.090909,1,0.090909,1,36047029600,11214
296,2005,0,10,10,11,10,10,-0.090909,-1,0,0,0,0,36047029600,11214
296,2005,1,12,10,16,8,8,-0.25,-4,0.5,4,0.5,4,36047029600,11214
296,2005,2,15,12,8,8,8,0.875,7,0.875,7,0.875,7,36047029600,11214
296,2005,3,11,15,8,9,9,0.375,3,0.222222,2,0.222222,2,36047029600,11214
296,2005,4,6,11,12,8,8,-0.5,-6,-0.25,-2,-0.25,-2,36047029600,11214
296,2005,5,11,6,12,10,10,-0.083333,-1,0.1,1,0.1,1,36047029600,11214
296,2006,0,14,14,10,13,13,0.4,4,0.076923,1,0.076923,1,36047029600,11214
296,2006,1,9,14,12,10,10,-0.25,-3,-0.1,-1,-0.1,-1,36047029600,11214
296,2006,2,11,9,15,10,10,-0.266667,-4,0.1,1,0.1,1,36047029600,11214
296,2006,3,12,11,11,9,9,0.090909,1,0.333333,3,0.333333,3,36047029600,11214
296,2006,4,11,12,6,11,11,0.833333,5,0,0,0,0,36047029600,11214
296,2006,5,6,11,11,9,9,-0.454545,-5,-0.333333,-3,-0.333333,-3,36047029600,11214
296,2007,0,10,10,14,11,11,-0.285714,-4,-0.090909,-1,-0.090909,-1,36047029600,11214
296,2007,1,12,10,9,16,16,0.333333,3,-0.25,-4,-0.25,-4,36047029600,11214
296,2007,2,10,12,11,8,8,-0.090909,-1,0.25,2,0.25,2,36047029600,11214
296,2007,3,10,10,12,8,8,-0.166667,-2,0.25,2,0.25,2,36047029600,11214
296,2007,4,14,10,11,12,12,0.272727,3,0.166667,2,0.166667,2,36047029600,11214
296,2007,5,12,14,6,12,12,1,6,0,0,0,0,36047029600,11214
296,2008,0,8,8,10,10,10,-0.2,-2,-0.2,-2,-0.2,-2,36047029600,11214
296,2008,1,10,8,12,12,12,-0.166667,-2,-0.166667,-2,-0.166667,-2,36047029600,11214
296,2008,2,12,10,10,15,15,0.2,2,-0.2,-3,-0.2,-3,36047029600,11214
296,2008,3,9,12,10,11,11,-0.1,-1,-0.181818,-2,-0.181818,-2,36047029600,11214
296,2008,4,9,9,14,6,6,-0.357143,-5,0.5,3,0.5,3,36047029600,11214
296,2008,5,13,9,12,11,11,0.083333,1,0.181818,2,0.181818,2,36047029600,11214
296,2009,0,9,9,8,14,14,0.125,1,-0.357143,-5,-0.357143,-5,36047029600,11214
296,2009,1,12,9,10,9,9,0.2,2,0.333333,3,0.333333,3,36047029600,11214
296,2009,2,9,12,12,11,11,-0.25,-3,-0.181818,-2,-0.181818,-2,36047029600,11214
296,2009,3,14,9,9,12,12,0.555556,5,0.166667,2,0.166667,2,36047029600,11214
296,2009,4,10,14,9,11,11,0.111111,1,-0.090909,-1,-0.090909,-1,36047029600,11214
296,2009,5,16,10,13,6,6,0.230769,3,1.666667,10,1.666667,10,36047029600,11214
296,2010,0,11,11,9,10,10,0.222222,2,0.1,1,0.1,1,36047029600,11214
296,2010,1,13,11,12,12,12,0.083333,1,0.083333,1,0.083333,1,36047029600,11214
296,2010,2,11,13,9,10,10,0.222222,2,0.1,1,0.1,1,36047029600,11214
296,2010,3,11,11,14,10,10,-0.214286,-3,0.1,1,0.1,1,36047029600,11214
296,2010,4,14,11,10,14,14,0.4,4,0,0,0,0,36047029600,11214
296,2010,5,11,14,16,12,12,-0.3125,-5,-0.083333,-1,-0.083333,-1,36047029600,11214
298,2006,0,1,1,0,0,0,1,1,1,1,1,1,36047029800,11214
298,2010,0,1,1,0,0,0,1,1,1,1,1,1,36047029800,11214
421,2006,2,1,0,0,0,0,1,1,1,1,1,1,36047042100,11221
421,2007,3,1,0,0,0,0,1,1,1,1,1,1,36047042100,11221
421,2008,4,1,0,0,0,0,1,1,1,1,1,1,36047042100,11221
428,2001,0,1,1,1,1,1,0,0,0,0,0,0,36047042800,11204
428,2001,2,1,0,1,1,1,0,0,0,0,0,0,36047042800,11204
428,2001,5,1,0,1,1,1,0,0,0,0,0,0,36047042800,11204
430,2001,0,29,29,29,29,29,0,0,0,0,0,0,36047043000,11204
430,2001,1,27,29,27,27,27,0,0,0,0,0,0,36047043000,11204
430,2001,2,29,27,29,29,29,0,0,0,0,0,0,36047043000,11204
430,2001,3,30,29,30,30,30,0,0,0,0,0,0,36047043000,11204
430,2001,4,26,30,26,26,26,0,0,0,0,0,0,36047043000,11204
430,2001,5,22,26,22,22,22,0,0,0,0,0,0,36047043000,11204
430,2002,0,17,17,29,17,17,-0.413793,-12,0,0,0,0,36047043000,11204
430,2002,1,29,17,27,29,29,0.074074,2,0,0,0,0,36047043000,11204
430,2002,2,24,29,29,24,24,-0.172414,-5,0,0,0,0,36047043000,11204
430,2002,3,29,24,30,29,29,-0.033333,-1,0,0,0,0,36047043000,11204
430,2002,4,26,29,26,26,26,0,0,0,0,0,0,36047043000,11204
430,2002,5,26,26,22,26,26,0.181818,4,0,0,0,0,36047043000,11204
430,2003,0,19,19,17,19,19,0.117647,2,0,0,0,0,36047043000,11204
430,2003,1,20,19,29,20,20,-0.310345,-9,0,0,0,0,36047043000,11204
430,2003,2,25,20,24,25,25,0.041667,1,0,0,0,0,36047043000,11204
430,2003,3,24,25,29,24,24,-0.172414,-5,0,0,0,0,36047043000,11204
430,2003,4,29,24,26,29,29,0.115385,3,0,0,0,0,36047043000,11204
430,2003,5,28,29,26,28,28,0.076923,2,0,0,0,0,36047043000,11204
430,2004,0,24,24,19,29,29,0.263158,5,-0.172414,-5,-0.172414,-5,36047043000,11204
430,2004,1,17,24,20,27,27,-0.15,-3,-0.37037,-10,-0.37037,-10,36047043000,11204
430,2004,2,21,17,25,29,29,-0.16,-4,-0.275862,-8,-0.275862,-8,36047043000,11204
430,2004,3,22,21,24,30,30,-0.083333,-2,-0.266667,-8,-0.266667,-8,36047043000,11204
430,2004,4,25,22,29,26,26,-0.137931,-4,-0.038462,-1,-0.038462,-1,36047043000,11204
430,2004,5,26,25,28,22,22,-0.071429,-2,0.181818,4,0.181818,4,36047043000,11204
430,2005,0,25,25,24,17,17,0.041667,1,0.470588,8,0.470588,8,36047043000,11204
430,2005,1,25,25,17,29,29,0.470588,8,-0.137931,-4,-0.137931,-4,36047043000,11204
430,2005,2,21,25,21,24,24,0,0,-0.125,-3,-0.125,-3,36047043000,11204
430,2005,3,21,21,22,29,29,-0.045455,-1,-0.275862,-8,-0.275862,-8,36047043000,11204
430,2005,4,27,21,25,26,26,0.08,2,0.038462,1,0.038462,1,36047043000,11204
430,2005,5,21,27,26,26,26,-0.192308,-5,-0.192308,-5,-0.192308,-5,36047043000,11204
430,2006,0,19,19,25,19,19,-0.24,-6,0,0,0,0,36047043000,11204
430,2006,1,20,19,25,20,20,-0.2,-5,0,0,0,0,36047043000,11204
430,2006,2,25,20,21,25,25,0.190476,4,0,0,0,0,36047043000,11204
430,2006,3,16,25,21,24,24,-0.238095,-5,-0.333333,-8,-0.333333,-8,36047043000,11204
430,2006,4,21,16,27,29,29,-0.222222,-6,-0.275862,-8,-0.275862,-8,36047043000,11204
430,2006,5,27,21,21,28,28,0.285714,6,-0.035714,-1,-0.035714,-1,36047043000,11204
430,2007,0,17,17,19,24,24,-0.105263,-2,-0.291667,-7,-0.291667,-7,36047043000,11204
430,2007,1,21,17,20,17,17,0.05,1,0.235294,4,0.235294,4,36047043000,11204
430,2007,2,22,21,25,21,21,-0.12,-3,0.047619,1,0.047619,1,36047043000,11204
430,2007,3,23,22,16,22,22,0.4375,7,0.045455,1,0.045455,1,36047043000,11204
430,2007,4,17,23,21,25,25,-0.190476,-4,-0.32,-8,-0.32,-8,36047043000,11204
430,2007,5,23,17,27,26,26,-0.148148,-4,-0.115385,-3,-0.115385,-3,36047043000,11204
430,2008,0,29,29,17,25,25,0.705882,12,0.16,4,0.16,4,36047043000,11204
430,2008,1,20,29,21,25,25,-0.047619,-1,-0.2,-5,-0.2,-5,36047043000,11204
430,2008,2,21,20,22,21,21,-0.045455,-1,0,0,0,0,36047043000,11204
430,2008,3,24,21,23,21,21,0.043478,1,0.142857,3,0.142857,3,36047043000,11204
430,2008,4,22,24,17,27,27,0.294118,5,-0.185185,-5,-0.185185,-5,36047043000,11204
430,2008,5,19,22,23,21,21,-0.173913,-4,-0.095238,-2,-0.095238,-2,36047043000,11204
430,2009,0,20,20,29,19,19,-0.310345,-9,0.052632,1,0.052632,1,36047043000,11204
430,2009,1,33,20,20,20,20,0.65,13,0.65,13,0.65,13,36047043000,11204
430,2009,2,25,33,21,25,25,0.190476,4,0,0,0,0,36047043000,11204
430,2009,3,23,25,24,16,16,-0.041667,-1,0.4375,7,0.4375,7,36047043000,11204
430,2009,4,24,23,22,21,21,0.090909,2,0.142857,3,0.142857,3,36047043000,11204
430,2009,5,22,24,19,27,27,0.157895,3,-0.185185,-5,-0.185185,-5,36047043000,11204
430,2010,0,29,29,20,17,17,0.45,9,0.705882,12,0.705882,12,36047043000,11204
430,2010,1,22,29,33,21,21,-0.333333,-11,0.047619,1,0.047619,1,36047043000,11204
430,2010,2,35,22,25,22,22,0.4,10,0.590909,13,0.590909,13,36047043000,11204
430,2010,3,25,35,23,23,23,0.086957,2,0.086957,2,0.086957,2,36047043000,11204
430,2010,4,23,25,24,17,17,-0.041667,-1,0.352941,6,0.352941,6,36047043000,11204
430,2010,5,18,23,22,23,23,-0.181818,-4,-0.217391,-5,-0.217391,-5,36047043000,11204
432,2001,0,20,20,20,20,20,0,0,0,0,0,0,36047043200,11204
432,2001,1,9,20,9,9,9,0,0,0,0,0,0,36047043200,11204
432,2001,2,16,9,16,16,16,0,0,0,0,0,0,36047043200,11204
432,2001,3,15,16,15,15,15,0,0,0,0,0,0,36047043200,11204
432,2001,4,14,15,14,14,14,0,0,0,0,0,0,36047043200,11204
432,2001,5,15,14,15,15,15,0,0,0,0,0,0,36047043200,11204
432,2002,0,15,15,20,15,15,-0.25,-5,0,0,0,0,36047043200,11204
432,2002,1,22,15,9,22,22,1.444444,13,0,0,0,0,36047043200,11204
432,2002,2,13,22,16,13,13,-0.1875,-3,0,0,0,0,36047043200,11204
432,2002,3,16,13,15,16,16,0.066667,1,0,0,0,0,36047043200,11204
432,2002,4,16,16,14,16,16,0.142857,2,0,0,0,0,36047043200,11204
432,2002,5,19,16,15,19,19,0.266667,4,0,0,0,0,36047043200,11204
432,2003,0,16,16,15,16,16,0.066667,1,0,0,0,0,36047043200,11204
432,2003,1,14,16,22,14,14,-0.363636,-8,0,0,0,0,36047043200,11204
432,2003,2,21,14,13,21,21,0.615385,8,0,0,0,0,36047043200,11204
432,2003,3,11,21,16,11,11,-0.3125,-5,0,0,0,0,36047043200,11204
432,2003,4,16,11,16,16,16,0,0,0,0,0,0,36047043200,11204
432,2003,5,15,16,19,15,15,-0.210526,-4,0,0,0,0,36047043200,11204
432,2004,0,8,8,16,20,20,-0.5,-8,-0.6,-12,-0.6,-12,36047043200,11204
432,2004,1,19,8,14,9,9,0.357143,5,1.111111,10,1.111111,10,36047043200,11204
432,2004,2,12,19,21,16,16,-0.428571,-9,-0.25,-4,-0.25,-4,36047043200,11204
432,2004,3,19,12,11,15,15,0.727273,8,0.266667,4,0.266667,4,36047043200,11204
432,2004,4,14,19,16,14,14,-0.125,-2,0,0,0,0,36047043200,11204
432,2004,5,15,14,15,15,15,0,0,0,0,0,0,36047043200,11204
432,2005,0,19,19,8,15,15,1.375,11,0.266667,4,0.266667,4,36047043200,11204
432,2005,1,5,19,19,22,22,-0.736842,-14,-0.772727,-17,-0.772727,-17,36047043200,11204
432,2005,2,17,5,12,13,13,0.416667,5,0.307692,4,0.307692,4,36047043200,11204
432,2005,3,14,17,19,16,16,-0.263158,-5,-0.125,-2,-0.125,-2,36047043200,11204
432,2005,4,14,14,14,16,16,0,0,-0.125,-2,-0.125,-2,36047043200,11204
432,2005,5,15,14,15,19,19,0,0,-0.210526,-4,-0.210526,-4,36047043200,11204
432,2006,0,10,10,19,16,16,-0.473684,-9,-0.375,-6,-0.375,-6,36047043200,11204
432,2006,1,23,10,5,14,14,3.6,18,0.642857,9,0.642857,9,36047043200,11204
432,2006,2,4,23,17,21,21,-0.764706,-13,-0.809524,-17,-0.809524,-17,36047043200,11204
432,2006,3,19,4,14,11,11,0.357143,5,0.727273,8,0.727273,8,36047043200,11204
432,2006,4,11,19,14,16,16,-0.214286,-3,-0.3125,-5,-0.3125,-5,36047043200,11204
432,2006,5,13,11,15,15,15,-0.133333,-2,-0.133333,-2,-0.133333,-2,36047043200,11204
432,2007,0,19,19,10,8,8,0.9,9,1.375,11,1.375,11,36047043200,11204
432,2007,1,11,19,23,19,19,-0.521739,-12,-0.421053,-8,-0.421053,-8,36047043200,11204
432,2007,2,22,11,4,12,12,4.5,18,0.833333,10,0.833333,10,36047043200,11204
432,2007,3,5,22,19,19,19,-0.736842,-14,-0.736842,-14,-0.736842,-14,36047043200,11204
432,2007,4,18,5,11,14,14,0.636364,7,0.285714,4,0.285714,4,36047043200,11204
432,2007,5,11,18,13,15,15,-0.153846,-2,-0.266667,-4,-0.266667,-4,36047043200,11204
432,2008,0,16,16,19,19,19,-0.157895,-3,-0.157895,-3,-0.157895,-3,36047043200,11204
432,2008,1,18,16,11,5,5,0.636364,7,2.6,13,2.6,13,36047043200,11204
432,2008,2,13,18,22,17,17,-0.409091,-9,-0.235294,-4,-0.235294,-4,36047043200,11204
432,2008,3,19,13,5,14,14,2.8,14,0.357143,5,0.357143,5,36047043200,11204
432,2008,4,6,19,18,14,14,-0.666667,-12,-0.571429,-8,-0.571429,-8,36047043200,11204
432,2008,5,17,6,11,15,15,0.545455,6,0.133333,2,0.133333,2,36047043200,11204
432,2009,0,13,13,16,10,10,-0.1875,-3,0.3,3,0.3,3,36047043200,11204
432,2009,1,15,13,18,23,23,-0.166667,-3,-0.347826,-8,-0.347826,-8,36047043200,11204
432,2009,2,22,15,13,4,4,0.692308,9,4.5,18,4.5,18,36047043200,11204
432,2009,3,11,22,19,19,19,-0.421053,-8,-0.421053,-8,-0.421053,-8,36047043200,11204
432,2009,4,19,11,6,11,11,2.166667,13,0.727273,8,0.727273,8,36047043200,11204
432,2009,5,8,19,17,13,13,-0.529412,-9,-0.384615,-5,-0.384615,-5,36047043200,11204
432,2010,0,18,18,13,19,19,0.384615,5,-0.052632,-1,-0.052632,-1,36047043200,11204
432,2010,1,13,18,15,11,11,-0.133333,-2,0.181818,2,0.181818,2,36047043200,11204
432,2010,2,16,13,22,22,22,-0.272727,-6,-0.272727,-6,-0.272727,-6,36047043200,11204
432,2010,3,22,16,11,5,5,1,11,3.4,17,3.4,17,36047043200,11204
432,2010,4,12,22,19,18,18,-0.368421,-7,-0.333333,-6,-0.333333,-6,36047043200,11204
432,2010,5,16,12,8,11,11,1,8,0.454545,5,0.454545,5,36047043200,11204
434,2002,1,1,0,0,1,1,1,1,0,0,0,0,36047043400,11204
436,2001,2,1,0,1,1,1,0,0,0,0,0,0,36047043600,11204
464,2001,3,1,0,1,1,1,0,0,0,0,0,0,36047046400,11204
464,2001,5,1,0,1,1,1,0,0,0,0,0,0,36047046400,11204
464,2002,4,1,0,0,1,1,1,1,0,0,0,0,36047046400,11204
464,2006,3,1,0,0,0,0,1,1,1,1,1,1,36047046400,11204
464,2007,4,1,0,0,0,0,1,1,1,1,1,1,36047046400,11204
464,2008,0,1,1,0,0,0,1,1,1,1,1,1,36047046400,11204
464,2008,5,1,0,0,0,0,1,1,1,1,1,1,36047046400,11204
464,2009,1,1,0,0,0,0,1,1,1,1,1,1,36047046400,11204
464,2010,2,1,0,0,0,0,1,1,1,1,1,1,36047046400,11204
468,2001,3,1,0,1,1,1,0,0,0,0,0,0,36047046800,11204
468,2001,4,1,1,1,1,1,0,0,0,0,0,0,36047046800,11204
468,2001,5,2,1,2,2,2,0,0,0,0,0,0,36047046800,11204
468,2002,0,1,1,0,1,1,1,1,0,0,0,0,36047046800,11204
468,2002,3,1,0,1,1,1,0,0,0,0,0,0,36047046800,11204
468,2002,4,2,1,1,2,2,1,1,0,0,0,0,36047046800,11204
468,2002,5,1,2,2,1,1,-0.5,-1,0,0,0,0,36047046800,11204
468,2003,0,1,1,1,1,1,0,0,0,0,0,0,36047046800,11204
468,2003,1,2,1,0,2,2,1,2,0,0,0,0,36047046800,11204
468,2003,4,1,0,2,1,1,-0.5,-1,0,0,0,0,36047046800,11204
468,2003,5,2,1,1,2,2,1,1,0,0,0,0,36047046800,11204
468,2004,0,2,2,1,0,0,1,1,1,2,1,2,36047046800,11204
468,2004,2,2,0,0,0,0,1,2,1,2,1,2,36047046800,11204
468,2004,5,1,0,2,2,2,-0.5,-1,-0.5,-1,-0.5,-1,36047046800,11204
468,2005,0,1,1,2,1,1,-0.5,-1,0,0,0,0,36047046800,11204
468,2005,1,2,1,0,0,0,1,2,1,2,1,2,36047046800,11204
468,2005,3,1,0,1,1,1,0,0,0,0,0,0,36047046800,11204
468,2006,0,1,1,1,1,1,0,0,0,0,0,0,36047046800,11204
468,2006,1,1,1,2,2,2,-0.5,-1,-0.5,-1,-0.5,-1,36047046800,11204
468,2006,2,3,1,0,0,0,1,3,1,3,1,3,36047046800,11204
468,2007,1,1,0,1,0,0,0,0,1,1,1,1,36047046800,11204
468,2007,2,2,1,3,2,2,-0.333333,-1,0,0,0,0,36047046800,11204
468,2007,3,2,2,0,0,0,1,2,1,2,1,2,36047046800,11204
468,2008,0,1,1,1,1,1,0,0,0,0,0,0,36047046800,11204
468,2008,2,1,0,2,0,0,-0.5,-1,1,1,1,1,36047046800,11204
468,2008,3,1,1,2,1,1,-0.5,-1,0,0,0,0,36047046800,11204
468,2008,4,2,1,0,0,0,1,2,1,2,1,2,36047046800,11204
468,2009,0,1,1,1,1,1,0,0,0,0,0,0,36047046800,11204
468,2009,1,1,1,1,1,1,0,0,0,0,0,0,36047046800,11204
468,2009,3,1,0,1,0,0,0,0,1,1,1,1,36047046800,11204
468,2009,4,1,1,2,0,0,-0.5,-1,1,1,1,1,36047046800,11204
468,2010,0,2,2,1,0,0,1,1,1,2,1,2,36047046800,11204
468,2010,1,1,2,1,1,1,0,0,0,0,0,0,36047046800,11204
468,2010,4,1,0,1,0,0,0,0,1,1,1,1,36047046800,11204
468,2010,5,1,1,0,0,0,1,1,1,1,1,1,36047046800,11204
470,2001,0,1,1,1,1,1,0,0,0,0,0,0,36047047000,11204
470,2001,1,2,1,2,2,2,0,0,0,0,0,0,36047047000,11204
470,2001,2,3,2,3,3,3,0,0,0,0,0,0,36047047000,11204
470,2001,3,3,3,3,3,3,0,0,0,0,0,0,36047047000,11204
470,2001,5,2,0,2,2,2,0,0,0,0,0,0,36047047000,11204
470,2002,1,1,0,2,1,1,-0.5,-1,0,0,0,0,36047047000,11204
470,2002,2,2,1,3,2,2,-0.333333,-1,0,0,0,0,36047047000,11204
470,2002,3,2,2,3,2,2,-0.333333,-1,0,0,0,0,36047047000,11204
470,2002,4,3,2,0,3,3,1,3,0,0,0,0,36047047000,11204
470,2003,0,1,1,0,1,1,1,1,0,0,0,0,36047047000,11204
470,2003,2,1,0,2,1,1,-0.5,-1,0,0,0,0,36047047000,11204
470,2003,4,2,0,3,2,2,-0.333333,-1,0,0,0,0,36047047000,11204
470,2003,5,1,2,0,1,1,1,1,0,0,0,0,36047047000,11204
470,2004,0,1,1,1,1,1,0,0,0,0,0,0,36047047000,11204
470,2004,1,1,1,2,2,2,-0.5,-1,-0.5,-1,-0.5,-1,36047047000,11204
470,2004,3,2,0,3,3,3,-0.333333,-1,-0.333333,-1,-0.333333,-1,36047047000,11204
470,2004,4,1,2,2,0,0,-0.5,-1,1,1,1,1,36047047000,11204
470,2004,5,3,1,1,2,2,2,2,0.5,1,0.5,1,36047047000,11204
470,2005,0,1,1,1,0,0,0,0,1,1,1,1,36047047000,11204
470,2005,1,1,1,1,1,1,0,0,0,0,0,0,36047047000,11204
470,2005,3,1,0,2,2,2,-0.5,-1,-0.5,-1,-0.5,-1,36047047000,11204
470,2005,4,2,1,1,3,3,1,1,-0.333333,-1,-0.333333,-1,36047047000,11204
470,2006,0,1,1,1,1,1,0,0,0,0,0,0,36047047000,11204
470,2006,1,2,1,1,0,0,1,1,1,2,1,2,36047047000,11204
470,2006,2,2,2,1,1,1,1,1,1,1,1,1,36047047000,11204
470,2006,3,1,2,1,0,0,0,0,1,1,1,1,36047047000,11204
470,2006,4,1,1,2,2,2,-0.5,-1,-0.5,-1,-0.5,-1,36047047000,11204
470,2006,5,1,1,1,1,1,0,0,0,0,0,0,36047047000,11204
470,2007,0,1,1,1,1,1,0,0,0,0,0,0,36047047000,11204
470,2007,1,1,1,2,1,1,-0.5,-1,0,0,0,0,36047047000,11204
470,2007,2,1,1,2,0,0,-0.5,-1,1,1,1,1,36047047000,11204
470,2007,4,1,0,1,1,1,0,0,0,0,0,0,36047047000,11204
470,2007,5,2,1,1,3,3,1,1,-0.333333,-1,-0.333333,-1,36047047000,11204
470,2008,1,1,0,1,1,1,0,0,0,0,0,0,36047047000,11204
470,2008,2,2,1,1,0,0,1,1,1,2,1,2,36047047000,11204
470,2008,3,1,2,1,1,1,0,0,0,0,0,0,36047047000,11204
470,2008,5,1,0,2,0,0,-0.5,-1,1,1,1,1,36047047000,11204
470,2009,0,2,2,1,1,1,1,1,1,1,1,1,36047047000,11204
470,2009,1,1,2,1,2,2,0,0,-0.5,-1,-0.5,-1,36047047000,11204
470,2009,2,1,1,2,2,2,-0.5,-1,-0.5,-1,-0.5,-1,36047047000,11204
470,2009,4,1,0,1,1,1,0,0,0,0,0,0,36047047000,11204
470,2010,0,4,4,2,1,1,1,2,3,3,3,3,36047047000,11204
470,2010,1,2,4,1,1,1,1,1,1,1,1,1,36047047000,11204
470,2010,2,1,2,1,1,1,0,0,0,0,0,0,36047047000,11204
470,2010,3,1,1,0,0,0,1,1,1,1,1,1,36047047000,11204
470,2010,5,2,0,2,2,2,0,0,0,0,0,0,36047047000,11204
472,2001,2,2,0,2,2,2,0,0,0,0,0,0,36047047200,11204
472,2001,3,1,2,1,1,1,0,0,0,0,0,0,36047047200,11204
472,2001,4,1,1,1,1,1,0,0,0,0,0,0,36047047200,11204
472,2001,5,1,1,1,1,1,0,0,0,0,0,0,36047047200,11204
472,2002,0,2,2,0,2,2,1,2,0,0,0,0,36047047200,11204
472,2002,3,2,0,1,2,2,1,1,0,0,0,0,36047047200,11204
472,2002,4,1,2,1,1,1,0,0,0,0,0,0,36047047200,11204
472,2002,5,1,1,1,1,1,0,0,0,0,0,0,36047047200,11204
472,2003,1,1,0,0,1,1,1,1,0,0,0,0,36047047200,11204
472,2003,4,2,0,1,2,2,1,1,0,0,0,0,36047047200,11204
472,2004,2,1,0,2,2,2,-0.5,-1,-0.5,-1,-0.5,-1,36047047200,11204
472,2004,5,2,0,1,1,1,1,1,1,1,1,1,36047047200,11204
472,2005,0,1,1,2,2,2,-0.5,-1,-0.5,-1,-0.5,-1,36047047200,11204
472,2009,2,1,0,0,0,0,1,1,1,1,1,1,36047047200,11204
474,2001,0,1,1,1,1,1,0,0,0,0,0,0,36047047400,11204
474,2001,1,2,1,2,2,2,0,0,0,0,0,0,36047047400,11204
474,2001,2,3,2,3,3,3,0,0,0,0,0,0,36047047400,11204
474,2001,3,6,3,6,6,6,0,0,0,0,0,0,36047047400,11204
474,2001,4,3,6,3,3,3,0,0,0,0,0,0,36047047400,11204
474,2001,5,5,3,5,5,5,0,0,0,0,0,0,36047047400,11204
474,2002,1,1,0,2,1,1,-0.5,-1,0,0,0,0,36047047400,11204
474,2002,2,2,1,3,2,2,-0.333333,-1,0,0,0,0,36047047400,11204
474,2002,3,2,2,6,2,2,-0.666667,-4,0,0,0,0,36047047400,11204
474,2002,4,4,2,3,4,4,0.333333,1,0,0,0,0,36047047400,11204
474,2002,5,4,4,5,4,4,-0.2,-1,0,0,0,0,36047047400,11204
474,2003,0,2,2,0,2,2,1,2,0,0,0,0,36047047400,11204
474,2003,1,1,2,1,1,1,0,0,0,0,0,0,36047047400,11204
474,2003,2,1,1,2,1,1,-0.5,-1,0,0,0,0,36047047400,11204
474,2003,4,2,0,4,2,2,-0.5,-2,0,0,0,0,36047047400,11204
474,2003,5,3,2,4,3,3,-0.25,-1,0,0,0,0,36047047400,11204
474,2004,0,4,4,2,1,1,1,2,3,3,3,3,36047047400,11204
474,2004,1,5,4,1,2,2,4,4,1.5,3,1.5,3,36047047400,11204
474,2004,2,1,5,1,3,3,0,0,-0.666667,-2,-0.666667,-2,36047047400,11204
474,2004,5,3,0,3,5,5,0,0,-0.4,-2,-0.4,-2,36047047400,11204
474,2005,1,3,0,5,1,1,-0.4,-2,2,2,2,2,36047047400,11204
474,2005,2,5,3,1,2,2,4,4,1.5,3,1.5,3,36047047400,11204
474,2005,3,2,5,2,2,2,0,0,0,0,0,0,36047047400,11204
474,2005,5,1,0,3,4,4,-0.666667,-2,-0.75,-3,-0.75,-3,36047047400,11204
474,2006,0,2,2,2,2,2,0,0,0,0,0,0,36047047400,11204
474,2006,1,2,2,3,1,1,-0.333333,-1,1,1,1,1,36047047400,11204
474,2006,2,1,2,5,1,1,-0.8,-4,0,0,0,0,36047047400,11204
474,2006,3,4,1,2,0,0,1,2,1,4,1,4,36047047400,11204
474,2006,4,2,4,2,2,2,0,0,0,0,0,0,36047047400,11204
474,2007,0,2,2,2,4,4,0,0,-0.5,-2,-0.5,-2,36047047400,11204
474,2007,2,3,0,1,1,1,2,2,2,2,2,2,36047047400,11204
474,2007,3,1,3,4,0,0,-0.75,-3,1,1,1,1,36047047400,11204
474,2007,4,2,1,2,0,0,0,0,1,2,1,2,36047047400,11204
474,2007,5,2,2,3,3,3,-0.333333,-1,-0.333333,-1,-0.333333,-1,36047047400,11204
474,2008,0,1,1,2,0,0,-0.5,-1,1,1,1,1,36047047400,11204
474,2008,1,2,1,3,3,3,-0.333333,-1,-0.333333,-1,-0.333333,-1,36047047400,11204
474,2008,3,2,0,1,2,2,1,1,0,0,0,0,36047047400,11204
474,2008,4,1,2,2,0,0,-0.5,-1,1,1,1,1,36047047400,11204
474,2008,5,1,1,2,1,1,-0.5,-1,0,0,0,0,36047047400,11204
474,2009,0,1,1,1,2,2,0,0,-0.5,-1,-0.5,-1,36047047400,11204
474,2009,1,2,1,2,2,2,0,0,0,0,0,0,36047047400,11204
474,2009,2,3,2,1,1,1,2,2,2,2,2,2,36047047400,11204
474,2009,4,2,0,1,2,2,1,1,0,0,0,0,36047047400,11204
474,2009,5,2,2,1,0,0,1,1,1,2,1,2,36047047400,11204
474,2010,0,4,4,1,2,2,3,3,1,2,1,2,36047047400,11204
474,2010,1,1,4,2,0,0,-0.5,-1,1,1,1,1,36047047400,11204
474,2010,2,4,1,3,3,3,0.333333,1,0.333333,1,0.333333,1,36047047400,11204
474,2010,3,1,4,1,1,1,0,0,0,0,0,0,36047047400,11204
474,2010,4,1,1,2,2,2,-0.5,-1,-0.5,-1,-0.5,-1,36047047400,11204
476,2001,0,4,4,4,4,4,0,0,0,0,0,0,36047047600,11204
476,2001,1,5,4,5,5,5,0,0,0,0,0,0,36047047600,11204
476,2001,2,7,5,7,7,7,0,0,0,0,0,0,36047047600,11204
476,2001,3,4,7,4,4,4,0,0,0,0,0,0,36047047600,11204
476,2001,4,3,4,3,3,3,0,0,0,0,0,0,36047047600,11204
476,2001,5,2,3,2,2,2,0,0,0,0,0,0,36047047600,11204
476,2002,0,6,6,4,6,6,0.5,2,0,0,0,0,36047047600,11204
476,2002,1,6,6,5,6,6,0.2,1,0,0,0,0,36047047600,11204
476,2002,2,4,6,7,4,4,-0.428571,-3,0,0,0,0,36047047600,11204
476,2002,3,8,4,4,8,8,1,4,0,0,0,0,36047047600,11204
476,2002,4,4,8,3,4,4,0.333333,1,0,0,0,0,36047047600,11204
476,2002,5,4,4,2,4,4,1,2,0,0,0,0,36047047600,11204
476,2003,0,3,3,6,3,3,-0.5,-3,0,0,0,0,36047047600,11204
476,2003,1,6,3,6,6,6,0,0,0,0,0,0,36047047600,11204
476,2003,2,6,6,4,6,6,0.5,2,0,0,0,0,36047047600,11204
476,2003,3,1,6,8,1,1,-0.875,-7,0,0,0,0,36047047600,11204
476,2003,4,6,1,4,6,6,0.5,2,0,0,0,0,36047047600,11204
476,2003,5,2,6,4,2,2,-0.5,-2,0,0,0,0,36047047600,11204
476,2004,0,2,2,3,4,4,-0.333333,-1,-0.5,-2,-0.5,-2,36047047600,11204
476,2004,1,3,2,6,5,5,-0.5,-3,-0.4,-2,-0.4,-2,36047047600,11204
476,2004,2,3,3,6,7,7,-0.5,-3,-0.571429,-4,-0.571429,-4,36047047600,11204
476,2004,3,4,3,1,4,4,3,3,0,0,0,0,36047047600,11204
476,2004,4,2,4,6,3,3,-0.666667,-4,-0.333333,-1,-0.333333,-1,36047047600,11204
476,2004,5,5,2,2,2,2,1.5,3,1.5,3,1.5,3,36047047600,11204
476,2005,0,2,2,2,6,6,0,0,-0.666667,-4,-0.666667,-4,36047047600,11204
476,2005,1,3,2,3,6,6,0,0,-0.5,-3,-0.5,-3,36047047600,11204
476,2005,2,3,3,3,4,4,0,0,-0.25,-1,-0.25,-1,36047047600,11204
476,2005,3,3,3,4,8,8,-0.25,-1,-0.625,-5,-0.625,-5,36047047600,11204
476,2005,4,3,3,2,4,4,0.5,1,-0.25,-1,-0.25,-1,36047047600,11204
476,2005,5,1,3,5,4,4,-0.8,-4,-0.75,-3,-0.75,-3,36047047600,11204
476,2006,0,3,3,2,3,3,0.5,1,0,0,0,0,36047047600,11204
476,2006,1,1,3,3,6,6,-0.666667,-2,-0.833333,-5,-0.833333,-5,36047047600,11204
476,2006,2,2,1,3,6,6,-0.333333,-1,-0.666667,-4,-0.666667,-4,36047047600,11204
476,2006,3,2,2,3,1,1,-0.333333,-1,1,1,1,1,36047047600,11204
476,2006,4,2,2,3,6,6,-0.333333,-1,-0.666667,-4,-0.666667,-4,36047047600,11204
476,2006,5,2,2,1,2,2,1,1,0,0,0,0,36047047600,11204
476,2007,0,5,5,3,2,2,0.666667,2,1.5,3,1.5,3,36047047600,11204
476,2007,1,2,5,1,3,3,1,1,-0.333333,-1,-0.333333,-1,36047047600,11204
476,2007,4,2,0,2,2,2,0,0,0,0,0,0,36047047600,11204
476,2008,0,11,11,5,2,2,1.2,6,4.5,9,4.5,9,36047047600,11204
476,2008,1,3,11,2,3,3,0.5,1,0,0,0,0,36047047600,11204
476,2008,2,2,3,3,3,3,-0.333333,-1,-0.333333,-1,-0.333333,-1,36047047600,11204
476,2008,5,1,0,1,1,1,0,0,0,0,0,0,36047047600,11204
476,2009,0,5,5,11,3,3,-0.545455,-6,0.666667,2,0.666667,2,36047047600,11204
476,2009,1,10,5,3,1,1,2.333333,7,9,9,9,9,36047047600,11204
476,2009,2,1,10,2,2,2,-0.5,-1,-0.5,-1,-0.5,-1,36047047600,11204
476,2009,3,1,1,2,2,2,-0.5,-1,-0.5,-1,-0.5,-1,36047047600,11204
476,2010,0,6,6,5,5,5,0.2,1,0.2,1,0.2,1,36047047600,11204
476,2010,1,6,6,10,2,2,-0.4,-4,2,4,2,4,36047047600,11204
476,2010,2,8,6,1,0,0,7,7,1,8,1,8,36047047600,11204
476,2010,3,2,8,1,0,0,1,1,1,2,1,2,36047047600,11204
476,2010,4,2,2,2,2,2,0,0,0,0,0,0,36047047600,11204
478,2001,0,17,17,17,17,17,0,0,0,0,0,0,36047047800,11204
478,2001,1,27,17,27,27,27,0,0,0,0,0,0,36047047800,11204
478,2001,2,29,27,29,29,29,0,0,0,0,0,0,36047047800,11204
478,2001,3,30,29,30,30,30,0,0,0,0,0,0,36047047800,11204
478,2001,4,17,30,17,17,17,0,0,0,0,0,0,36047047800,11204
478,2001,5,28,17,28,28,28,0,0,0,0,0,0,36047047800,11204
478,2002,0,13,13,17,13,13,-0.235294,-4,0,0,0,0,36047047800,11204
478,2002,1,13,13,27,13,13,-0.518519,-14,0,0,0,0,36047047800,11204
478,2002,2,20,13,29,20,20,-0.310345,-9,0,0,0,0,36047047800,11204
478,2002,3,27,20,30,27,27,-0.1,-3,0,0,0,0,36047047800,11204
478,2002,4,23,27,17,23,23,0.352941,6,0,0,0,0,36047047800,11204
478,2002,5,15,23,28,15,15,-0.464286,-13,0,0,0,0,36047047800,11204
478,2003,0,16,16,13,16,16,0.230769,3,0,0,0,0,36047047800,11204
478,2003,1,16,16,13,16,16,0.230769,3,0,0,0,0,36047047800,11204
478,2003,2,11,16,20,11,11,-0.45,-9,0,0,0,0,36047047800,11204
478,2003,3,19,11,27,19,19,-0.296296,-8,0,0,0,0,36047047800,11204
478,2003,4,24,19,23,24,24,0.043478,1,0,0,0,0,36047047800,11204
478,2003,5,24,24,15,24,24,0.6,9,0,0,0,0,36047047800,11204
478,2004,0,12,12,16,17,17,-0.25,-4,-0.294118,-5,-0.294118,-5,36047047800,11204
478,2004,1,13,12,16,27,27,-0.1875,-3,-0.518519,-14,-0.518519,-14,36047047800,11204
478,2004,2,19,13,11,29,29,0.727273,8,-0.344828,-10,-0.344828,-10,36047047800,11204
478,2004,3,10,19,19,30,30,-0.473684,-9,-0.666667,-20,-0.666667,-20,36047047800,11204
478,2004,4,13,10,24,17,17,-0.458333,-11,-0.235294,-4,-0.235294,-4,36047047800,11204
478,2004,5,25,13,24,28,28,0.041667,1,-0.107143,-3,-0.107143,-3,36047047800,11204
478,2005,0,10,10,12,13,13,-0.166667,-2,-0.230769,-3,-0.230769,-3,36047047800,11204
478,2005,1,13,10,13,13,13,0,0,0,0,0,0,36047047800,11204
478,2005,2,14,13,19,20,20,-0.263158,-5,-0.3,-6,-0.3,-6,36047047800,11204
478,2005,3,19,14,10,27,27,0.9,9,-0.296296,-8,-0.296296,-8,36047047800,11204
478,2005,4,10,19,13,23,23,-0.230769,-3,-0.565217,-13,-0.565217,-13,36047047800,11204
478,2005,5,13,10,25,15,15,-0.48,-12,-0.133333,-2,-0.133333,-2,36047047800,11204
478,2006,0,15,15,10,16,16,0.5,5,-0.0625,-1,-0.0625,-1,36047047800,11204
478,2006,1,11,15,13,16,16,-0.153846,-2,-0.3125,-5,-0.3125,-5,36047047800,11204
478,2006,2,8,11,14,11,11,-0.428571,-6,-0.272727,-3,-0.272727,-3,36047047800,11204
478,2006,3,11,8,19,19,19,-0.421053,-8,-0.421053,-8,-0.421053,-8,36047047800,11204
478,2006,4,16,11,10,24,24,0.6,6,-0.333333,-8,-0.333333,-8,36047047800,11204
478,2006,5,6,16,13,24,24,-0.538462,-7,-0.75,-18,-0.75,-18,36047047800,11204
478,2007,0,21,21,15,12,12,0.4,6,0.75,9,0.75,9,36047047800,11204
478,2007,1,11,21,11,13,13,0,0,-0.153846,-2,-0.153846,-2,36047047800,11204
478,2007,2,10,11,8,19,19,0.25,2,-0.473684,-9,-0.473684,-9,36047047800,11204
478,2007,3,7,10,11,10,10,-0.363636,-4,-0.3,-3,-0.3,-3,36047047800,11204
478,2007,4,10,7,16,13,13,-0.375,-6,-0.230769,-3,-0.230769,-3,36047047800,11204
478,2007,5,12,10,6,25,25,1,6,-0.52,-13,-0.52,-13,36047047800,11204
478,2008,0,12,12,21,10,10,-0.428571,-9,0.2,2,0.2,2,36047047800,11204
478,2008,1,20,12,11,13,13,0.818182,9,0.538462,7,0.538462,7,36047047800,11204
478,2008,2,12,20,10,14,14,0.2,2,-0.142857,-2,-0.142857,-2,36047047800,11204
478,2008,3,6,12,7,19,19,-0.142857,-1,-0.684211,-13,-0.684211,-13,36047047800,11204
478,2008,4,8,6,10,10,10,-0.2,-2,-0.2,-2,-0.2,-2,36047047800,11204
478,2008,5,8,8,12,13,13,-0.333333,-4,-0.384615,-5,-0.384615,-5,36047047800,11204
478,2009,0,16,16,12,15,15,0.333333,4,0.066667,1,0.066667,1,36047047800,11204
478,2009,1,16,16,20,11,11,-0.2,-4,0.454545,5,0.454545,5,36047047800,11204
478,2009,2,24,16,12,8,8,1,12,2,16,2,16,36047047800,11204
478,2009,3,11,24,6,11,11,0.833333,5,0,0,0,0,36047047800,11204
478,2009,4,8,11,8,16,16,0,0,-0.5,-8,-0.5,-8,36047047800,11204
478,2009,5,8,8,8,6,6,0,0,0.333333,2,0.333333,2,36047047800,11204
478,2010,0,18,18,16,21,21,0.125,2,-0.142857,-3,-0.142857,-3,36047047800,11204
478,2010,1,16,18,16,11,11,0,0,0.454545,5,0.454545,5,36047047800,11204
478,2010,2,17,16,24,10,10,-0.291667,-7,0.7,7,0.7,7,36047047800,11204
478,2010,3,19,17,11,7,7,0.727273,8,1.714286,12,1.714286,12,36047047800,11204
478,2010,4,13,19,8,10,10,0.625,5,0.3,3,0.3,3,36047047800,11204
478,2010,5,5,13,8,12,12,-0.375,-3,-0.583333,-7,-0.583333,-7,36047047800,11204
480,2001,0,11,11,11,11,11,0,0,0,0,0,0,36047048000,11218
480,2001,1,7,11,7,7,7,0,0,0,0,0,0,36047048000,11218
480,2001,2,8,7,8,8,8,0,0,0,0,0,0,36047048000,11218
480,2001,3,11,8,11,11,11,0,0,0,0,0,0,36047048000,11218
480,2001,4,9,11,9,9,9,0,0,0,0,0,0,36047048000,11218
480,2001,5,11,9,11,11,11,0,0,0,0,0,0,36047048000,11218
480,2002,0,9,9,11,9,9,-0.181818,-2,0,0,0,0,36047048000,11218
480,2002,1,10,9,7,10,10,0.428571,3,0,0,0,0,36047048000,11218
480,2002,2,6,10,8,6,6,-0.25,-2,0,0,0,0,36047048000,11218
480,2002,3,10,6,11,10,10,-0.090909,-1,0,0,0,0,36047048000,11218
480,2002,4,9,10,9,9,9,0,0,0,0,0,0,36047048000,11218
480,2002,5,7,9,11,7,7,-0.363636,-4,0,0,0,0,36047048000,11218
480,2003,0,5,5,9,5,5,-0.444444,-4,0,0,0,0,36047048000,11218
480,2003,1,5,5,10,5,5,-0.5,-5,0,0,0,0,36047048000,11218
480,2003,2,11,5,6,11,11,0.833333,5,0,0,0,0,36047048000,11218
480,2003,3,5,11,10,5,5,-0.5,-5,0,0,0,0,36047048000,11218
480,2003,4,13,5,9,13,13,0.444444,4,0,0,0,0,36047048000,11218
480,2003,5,11,13,7,11,11,0.571429,4,0,0,0,0,36047048000,11218
480,2004,0,6,6,5,11,11,0.2,1,-0.454545,-5,-0.454545,-5,36047048000,11218
480,2004,1,1,6,5,7,7,-0.8,-4,-0.857143,-6,-0.857143,-6,36047048000,11218
480,2004,2,4,1,11,8,8,-0.636364,-7,-0.5,-4,-0.5,-4,36047048000,11218
480,2004,3,7,4,5,11,11,0.4,2,-0.363636,-4,-0.363636,-4,36047048000,11218
480,2004,4,3,7,13,9,9,-0.769231,-10,-0.666667,-6,-0.666667,-6,36047048000,11218
480,2004,5,11,3,11,11,11,0,0,0,0,0,0,36047048000,11218
480,2005,0,3,3,6,9,9,-0.5,-3,-0.666667,-6,-0.666667,-6,36047048000,11218
480,2005,1,8,3,1,10,10,7,7,-0.2,-2,-0.2,-2,36047048000,11218
480,2005,2,4,8,4,6,6,0,0,-0.333333,-2,-0.333333,-2,36047048000,11218
480,2005,3,4,4,7,10,10,-0.428571,-3,-0.6,-6,-0.6,-6,36047048000,11218
480,2005,4,7,4,3,9,9,1.333333,4,-0.222222,-2,-0.222222,-2,36047048000,11218
480,2005,5,3,7,11,7,7,-0.727273,-8,-0.571429,-4,-0.571429,-4,36047048000,11218
480,2006,0,6,6,3,5,5,1,3,0.2,1,0.2,1,36047048000,11218
480,2006,1,2,6,8,5,5,-0.75,-6,-0.6,-3,-0.6,-3,36047048000,11218
480,2006,2,8,2,4,11,11,1,4,-0.272727,-3,-0.272727,-3,36047048000,11218
480,2006,3,1,8,4,5,5,-0.75,-3,-0.8,-4,-0.8,-4,36047048000,11218
480,2006,4,4,1,7,13,13,-0.428571,-3,-0.692308,-9,-0.692308,-9,36047048000,11218
480,2006,5,6,4,3,11,11,1,3,-0.454545,-5,-0.454545,-5,36047048000,11218
480,2007,0,10,10,6,6,6,0.666667,4,0.666667,4,0.666667,4,36047048000,11218
480,2007,1,6,10,2,1,1,2,4,5,5,5,5,36047048000,11218
480,2007,2,2,6,8,4,4,-0.75,-6,-0.5,-2,-0.5,-2,36047048000,11218
480,2007,3,5,2,1,7,7,4,4,-0.285714,-2,-0.285714,-2,36047048000,11218
480,2007,4,1,5,4,3,3,-0.75,-3,-0.666667,-2,-0.666667,-2,36047048000,11218
480,2007,5,4,1,6,11,11,-0.333333,-2,-0.636364,-7,-0.636364,-7,36047048000,11218
480,2008,0,6,6,10,3,3,-0.4,-4,1,3,1,3,36047048000,11218
480,2008,1,8,6,6,8,8,0.333333,2,0,0,0,0,36047048000,11218
480,2008,2,6,8,2,4,4,2,4,0.5,2,0.5,2,36047048000,11218
480,2008,3,2,6,5,4,4,-0.6,-3,-0.5,-2,-0.5,-2,36047048000,11218
480,2008,4,3,2,1,7,7,2,2,-0.571429,-4,-0.571429,-4,36047048000,11218
480,2008,5,3,3,4,3,3,-0.25,-1,0,0,0,0,36047048000,11218
480,2009,0,4,4,6,6,6,-0.333333,-2,-0.333333,-2,-0.333333,-2,36047048000,11218
480,2009,1,7,4,8,2,2,-0.125,-1,2.5,5,2.5,5,36047048000,11218
480,2009,2,5,7,6,8,8,-0.166667,-1,-0.375,-3,-0.375,-3,36047048000,11218
480,2009,3,5,5,2,1,1,1.5,3,4,4,4,4,36047048000,11218
480,2009,4,2,5,3,4,4,-0.333333,-1,-0.5,-2,-0.5,-2,36047048000,11218
480,2009,5,3,2,3,6,6,0,0,-0.5,-3,-0.5,-3,36047048000,11218
480,2010,0,10,10,4,10,10,1.5,6,0,0,0,0,36047048000,11218
480,2010,1,6,10,7,6,6,-0.142857,-1,0,0,0,0,36047048000,11218
480,2010,2,9,6,5,2,2,0.8,4,3.5,7,3.5,7,36047048000,11218
480,2010,3,5,9,5,5,5,0,0,0,0,0,0,36047048000,11218
480,2010,4,8,5,2,1,1,3,6,7,7,7,7,36047048000,11218
484,2001,0,34,34,34,34,34,0,0,0,0,0,0,36047048400,11218
484,2001,1,32,34,32,32,32,0,0,0,0,0,0,36047048400,11218
484,2001,2,28,32,28,28,28,0,0,0,0,0,0,36047048400,11218
484,2001,3,28,28,28,28,28,0,0,0,0,0,0,36047048400,11218
484,2001,4,31,28,31,31,31,0,0,0,0,0,0,36047048400,11218
484,2001,5,34,31,34,34,34,0,0,0,0,0,0,36047048400,11218
484,2002,0,29,29,34,29,29,-0.147059,-5,0,0,0,0,36047048400,11218
484,2002,1,33,29,32,33,33,0.03125,1,0,0,0,0,36047048400,11218
484,2002,2,29,33,28,29,29,0.035714,1,0,0,0,0,36047048400,11218
484,2002,3,32,29,28,32,32,0.142857,4,0,0,0,0,36047048400,11218
484,2002,4,22,32,31,22,22,-0.290323,-9,0,0,0,0,36047048400,11218
484,2002,5,29,22,34,29,29,-0.147059,-5,0,0,0,0,36047048400,11218
484,2003,0,25,25,29,25,25,-0.137931,-4,0,0,0,0,36047048400,11218
484,2003,1,24,25,33,24,24,-0.272727,-9,0,0,0,0,36047048400,11218
484,2003,2,29,24,29,29,29,0,0,0,0,0,0,36047048400,11218
484,2003,3,26,29,32,26,26,-0.1875,-6,0,0,0,0,36047048400,11218
484,2003,4,26,26,22,26,26,0.181818,4,0,0,0,0,36047048400,11218
484,2003,5,20,26,29,20,20,-0.310345,-9,0,0,0,0,36047048400,11218
484,2004,0,29,29,25,34,34,0.16,4,-0.147059,-5,-0.147059,-5,36047048400,11218
484,2004,1,30,29,24,32,32,0.25,6,-0.0625,-2,-0.0625,-2,36047048400,11218
484,2004,2,27,30,29,28,28,-0.068966,-2,-0.035714,-1,-0.035714,-1,36047048400,11218
484,2004,3,35,27,26,28,28,0.346154,9,0.25,7,0.25,7,36047048400,11218
484,2004,4,23,35,26,31,31,-0.115385,-3,-0.258065,-8,-0.258065,-8,36047048400,11218
484,2004,5,26,23,20,34,34,0.3,6,-0.235294,-8,-0.235294,-8,36047048400,11218
484,2005,0,26,26,29,29,29,-0.103448,-3,-0.103448,-3,-0.103448,-3,36047048400,11218
484,2005,1,26,26,30,33,33,-0.133333,-4,-0.212121,-7,-0.212121,-7,36047048400,11218
484,2005,2,31,26,27,29,29,0.148148,4,0.068966,2,0.068966,2,36047048400,11218
484,2005,3,27,31,35,32,32,-0.228571,-8,-0.15625,-5,-0.15625,-5,36047048400,11218
484,2005,4,25,27,23,22,22,0.086957,2,0.136364,3,0.136364,3,36047048400,11218
484,2005,5,24,25,26,29,29,-0.076923,-2,-0.172414,-5,-0.172414,-5,36047048400,11218
484,2006,0,21,21,26,25,25,-0.192308,-5,-0.16,-4,-0.16,-4,36047048400,11218
484,2006,1,22,21,26,24,24,-0.153846,-4,-0.083333,-2,-0.083333,-2,36047048400,11218
484,2006,2,28,22,31,29,29,-0.096774,-3,-0.034483,-1,-0.034483,-1,36047048400,11218
484,2006,3,32,28,27,26,26,0.185185,5,0.230769,6,0.230769,6,36047048400,11218
484,2006,4,29,32,25,26,26,0.16,4,0.115385,3,0.115385,3,36047048400,11218
484,2006,5,23,29,24,20,20,-0.041667,-1,0.15,3,0.15,3,36047048400,11218
484,2007,0,26,26,21,29,29,0.238095,5,-0.103448,-3,-0.103448,-3,36047048400,11218
484,2007,1,22,26,22,30,30,0,0,-0.266667,-8,-0.266667,-8,36047048400,11218
484,2007,2,20,22,28,27,27,-0.285714,-8,-0.259259,-7,-0.259259,-7,36047048400,11218
484,2007,3,28,20,32,35,35,-0.125,-4,-0.2,-7,-0.2,-7,36047048400,11218
484,2007,4,27,28,29,23,23,-0.068966,-2,0.173913,4,0.173913,4,36047048400,11218
484,2007,5,30,27,23,26,26,0.304348,7,0.153846,4,0.153846,4,36047048400,11218
484,2008,0,32,32,26,26,26,0.230769,6,0.230769,6,0.230769,6,36047048400,11218
484,2008,1,26,32,22,26,26,0.181818,4,0,0,0,0,36047048400,11218
484,2008,2,20,26,20,31,31,0,0,-0.354839,-11,-0.354839,-11,36047048400,11218
484,2008,3,20,20,28,27,27,-0.285714,-8,-0.259259,-7,-0.259259,-7,36047048400,11218
484,2008,4,25,20,27,25,25,-0.074074,-2,0,0,0,0,36047048400,11218
484,2008,5,29,25,30,24,24,-0.033333,-1,0.208333,5,0.208333,5,36047048400,11218
484,2009,0,33,33,32,21,21,0.03125,1,0.571429,12,0.571429,12,36047048400,11218
484,2009,1,47,33,26,22,22,0.807692,21,1.136364,25,1.136364,25,36047048400,11218
484,2009,2,29,47,20,28,28,0.45,9,0.035714,1,0.035714,1,36047048400,11218
484,2009,3,28,29,20,32,32,0.4,8,-0.125,-4,-0.125,-4,36047048400,11218
484,2009,4,20,28,25,29,29,-0.2,-5,-0.310345,-9,-0.310345,-9,36047048400,11218
484,2009,5,27,20,29,23,23,-0.068966,-2,0.173913,4,0.173913,4,36047048400,11218
484,2010,0,32,32,33,26,26,-0.030303,-1,0.230769,6,0.230769,6,36047048400,11218
484,2010,1,38,32,47,22,22,-0.191489,-9,0.727273,16,0.727273,16,36047048400,11218
484,2010,2,51,38,29,20,20,0.758621,22,1.55,31,1.55,31,36047048400,11218
484,2010,3,29,51,28,28,28,0.035714,1,0.035714,1,0.035714,1,36047048400,11218
484,2010,4,29,29,20,27,27,0.45,9,0.074074,2,0.074074,2,36047048400,11218
484,2010,5,25,29,27,30,30,-0.074074,-2,-0.166667,-5,-0.166667,-5,36047048400,11218
486,2001,0,45,45,45,45,45,0,0,0,0,0,0,36047048600,11218
486,2001,1,48,45,48,48,48,0,0,0,0,0,0,36047048600,11218
486,2001,2,40,48,40,40,40,0,0,0,0,0,0,36047048600,11218
486,2001,3,28,40,28,28,28,0,0,0,0,0,0,36047048600,11218
486,2001,4,39,28,39,39,39,0,0,0,0,0,0,36047048600,11218
486,2001,5,38,39,38,38,38,0,0,0,0,0,0,36047048600,11218
486,2002,0,23,23,45,23,23,-0.488889,-22,0,0,0,0,36047048600,11218
486,2002,1,38,23,48,38,38,-0.208333,-10,0,0,0,0,36047048600,11218
486,2002,2,47,38,40,47,47,0.175,7,0,0,0,0,36047048600,11218
486,2002,3,42,47,28,42,42,0.5,14,0,0,0,0,36047048600,11218
486,2002,4,29,42,39,29,29,-0.25641,-10,0,0,0,0,36047048600,11218
486,2002,5,41,29,38,41,41,0.078947,3,0,0,0,0,36047048600,11218
486,2003,0,31,31,23,31,31,0.347826,8,0,0,0,0,36047048600,11218
486,2003,1,23,31,38,23,23,-0.394737,-15,0,0,0,0,36047048600,11218
486,2003,2,41,23,47,41,41,-0.12766,-6,0,0,0,0,36047048600,11218
486,2003,3,45,41,42,45,45,0.071429,3,0,0,0,0,36047048600,11218
486,2003,4,31,45,29,31,31,0.068966,2,0,0,0,0,36047048600,11218
486,2003,5,29,31,41,29,29,-0.292683,-12,0,0,0,0,36047048600,11218
486,2004,0,28,28,31,45,45,-0.096774,-3,-0.377778,-17,-0.377778,-17,36047048600,11218
486,2004,1,33,28,23,48,48,0.434783,10,-0.3125,-15,-0.3125,-15,36047048600,11218
486,2004,2,22,33,41,40,40,-0.463415,-19,-0.45,-18,-0.45,-18,36047048600,11218
486,2004,3,39,22,45,28,28,-0.133333,-6,0.392857,11,0.392857,11,36047048600,11218
486,2004,4,42,39,31,39,39,0.354839,11,0.076923,3,0.076923,3,36047048600,11218
486,2004,5,31,42,29,38,38,0.068966,2,-0.184211,-7,-0.184211,-7,36047048600,11218
486,2005,0,31,31,28,23,23,0.107143,3,0.347826,8,0.347826,8,36047048600,11218
486,2005,1,33,31,33,38,38,0,0,-0.131579,-5,-0.131579,-5,36047048600,11218
486,2005,2,29,33,22,47,47,0.318182,7,-0.382979,-18,-0.382979,-18,36047048600,11218
486,2005,3,24,29,39,42,42,-0.384615,-15,-0.428571,-18,-0.428571,-18,36047048600,11218
486,2005,4,29,24,42,29,29,-0.309524,-13,0,0,0,0,36047048600,11218
486,2005,5,37,29,31,41,41,0.193548,6,-0.097561,-4,-0.097561,-4,36047048600,11218
486,2006,0,24,24,31,31,31,-0.225806,-7,-0.225806,-7,-0.225806,-7,36047048600,11218
486,2006,1,35,24,33,23,23,0.060606,2,0.521739,12,0.521739,12,36047048600,11218
486,2006,2,30,35,29,41,41,0.034483,1,-0.268293,-11,-0.268293,-11,36047048600,11218
486,2006,3,29,30,24,45,45,0.208333,5,-0.355556,-16,-0.355556,-16,36047048600,11218
486,2006,4,25,29,29,31,31,-0.137931,-4,-0.193548,-6,-0.193548,-6,36047048600,11218
486,2006,5,25,25,37,29,29,-0.324324,-12,-0.137931,-4,-0.137931,-4,36047048600,11218
486,2007,0,22,22,24,28,28,-0.083333,-2,-0.214286,-6,-0.214286,-6,36047048600,11218
486,2007,1,23,22,35,33,33,-0.342857,-12,-0.30303,-10,-0.30303,-10,36047048600,11218
486,2007,2,33,23,30,22,22,0.1,3,0.5,11,0.5,11,36047048600,11218
486,2007,3,29,33,29,39,39,0,0,-0.25641,-10,-0.25641,-10,36047048600,11218
486,2007,4,29,29,25,42,42,0.16,4,-0.309524,-13,-0.309524,-13,36047048600,11218
486,2007,5,20,29,25,31,31,-0.2,-5,-0.354839,-11,-0.354839,-11,36047048600,11218
486,2008,0,31,31,22,31,31,0.409091,9,0,0,0,0,36047048600,11218
486,2008,1,27,31,23,33,33,0.173913,4,-0.181818,-6,-0.181818,-6,36047048600,11218
486,2008,2,32,27,33,29,29,-0.030303,-1,0.103448,3,0.103448,3,36047048600,11218
486,2008,3,36,32,29,24,24,0.241379,7,0.5,12,0.5,12,36047048600,11218
486,2008,4,32,36,29,29,29,0.103448,3,0.103448,3,0.103448,3,36047048600,11218
486,2008,5,29,32,20,37,37,0.45,9,-0.216216,-8,-0.216216,-8,36047048600,11218
486,2009,0,30,30,31,24,24,-0.032258,-1,0.25,6,0.25,6,36047048600,11218
486,2009,1,34,30,27,35,35,0.259259,7,-0.028571,-1,-0.028571,-1,36047048600,11218
486,2009,2,36,34,32,30,30,0.125,4,0.2,6,0.2,6,36047048600,11218
486,2009,3,33,36,36,29,29,-0.083333,-3,0.137931,4,0.137931,4,36047048600,11218
486,2009,4,40,33,32,25,25,0.25,8,0.6,15,0.6,15,36047048600,11218
486,2009,5,39,40,29,25,25,0.344828,10,0.56,14,0.56,14,36047048600,11218
486,2010,0,34,34,30,22,22,0.133333,4,0.545455,12,0.545455,12,36047048600,11218
486,2010,1,35,34,34,23,23,0.029412,1,0.521739,12,0.521739,12,36047048600,11218
486,2010,2,39,35,36,33,33,0.083333,3,0.181818,6,0.181818,6,36047048600,11218
486,2010,3,37,39,33,29,29,0.121212,4,0.275862,8,0.275862,8,36047048600,11218
486,2010,4,36,37,40,29,29,-0.1,-4,0.241379,7,0.241379,7,36047048600,11218
486,2010,5,36,36,39,20,20,-0.076923,-3,0.8,16,0.8,16,36047048600,11218
488,2001,0,33,33,33,33,33,0,0,0,0,0,0,36047048800,11218
488,2001,1,41,33,41,41,41,0,0,0,0,0,0,36047048800,11218
488,2001,2,35,41,35,35,35,0,0,0,0,0,0,36047048800,11218
488,2001,3,44,35,44,44,44,0,0,0,0,0,0,36047048800,11218
488,2001,4,42,44,42,42,42,0,0,0,0,0,0,36047048800,11218
488,2001,5,47,42,47,47,47,0,0,0,0,0,0,36047048800,11218
488,2002,0,31,31,33,31,31,-0.060606,-2,0,0,0,0,36047048800,11218
488,2002,1,36,31,41,36,36,-0.121951,-5,0,0,0,0,36047048800,11218
488,2002,2,38,36,35,38,38,0.085714,3,0,0,0,0,36047048800,11218
488,2002,3,32,38,44,32,32,-0.272727,-12,0,0,0,0,36047048800,11218
488,2002,4,43,32,42,43,43,0.02381,1,0,0,0,0,36047048800,11218
488,2002,5,42,43,47,42,42,-0.106383,-5,0,0,0,0,36047048800,11218
488,2003,0,32,32,31,32,32,0.032258,1,0,0,0,0,36047048800,11218
488,2003,1,30,32,36,30,30,-0.166667,-6,0,0,0,0,36047048800,11218
488,2003,2,33,30,38,33,33,-0.131579,-5,0,0,0,0,36047048800,11218
488,2003,3,30,33,32,30,30,-0.0625,-2,0,0,0,0,36047048800,11218
488,2003,4,30,30,43,30,30,-0.302326,-13,0,0,0,0,36047048800,11218
488,2003,5,38,30,42,38,38,-0.095238,-4,0,0,0,0,36047048800,11218
488,2004,0,21,21,32,33,33,-0.34375,-11,-0.363636,-12,-0.363636,-12,36047048800,11218
488,2004,1,29,21,30,41,41,-0.033333,-1,-0.292683,-12,-0.292683,-12,36047048800,11218
488,2004,2,28,29,33,35,35,-0.151515,-5,-0.2,-7,-0.2,-7,36047048800,11218
488,2004,3,30,28,30,44,44,0,0,-0.318182,-14,-0.318182,-14,36047048800,11218
488,2004,4,31,30,30,42,42,0.033333,1,-0.261905,-11,-0.261905,-11,36047048800,11218
488,2004,5,27,31,38,47,47,-0.289474,-11,-0.425532,-20,-0.425532,-20,36047048800,11218
488,2005,0,21,21,21,31,31,0,0,-0.322581,-10,-0.322581,-10,36047048800,11218
488,2005,1,20,21,29,36,36,-0.310345,-9,-0.444444,-16,-0.444444,-16,36047048800,11218
488,2005,2,33,20,28,38,38,0.178571,5,-0.131579,-5,-0.131579,-5,36047048800,11218
488,2005,3,32,33,30,32,32,0.066667,2,0,0,0,0,36047048800,11218
488,2005,4,33,32,31,43,43,0.064516,2,-0.232558,-10,-0.232558,-10,36047048800,11218
488,2005,5,31,33,27,42,42,0.148148,4,-0.261905,-11,-0.261905,-11,36047048800,11218
488,2006,0,26,26,21,32,32,0.238095,5,-0.1875,-6,-0.1875,-6,36047048800,11218
488,2006,1,22,26,20,30,30,0.1,2,-0.266667,-8,-0.266667,-8,36047048800,11218
488,2006,2,25,22,33,33,33,-0.242424,-8,-0.242424,-8,-0.242424,-8,36047048800,11218
488,2006,3,29,25,32,30,30,-0.09375,-3,-0.033333,-1,-0.033333,-1,36047048800,11218
488,2006,4,28,29,33,30,30,-0.151515,-5,-0.066667,-2,-0.066667,-2,36047048800,11218
488,2006,5,37,28,31,38,38,0.193548,6,-0.026316,-1,-0.026316,-1,36047048800,11218
488,2007,0,29,29,26,21,21,0.115385,3,0.380952,8,0.380952,8,36047048800,11218
488,2007,1,23,29,22,29,29,0.045455,1,-0.206897,-6,-0.206897,-6,36047048800,11218
488,2007,2,21,23,25,28,28,-0.16,-4,-0.25,-7,-0.25,-7,36047048800,11218
488,2007,3,21,21,29,30,30,-0.275862,-8,-0.3,-9,-0.3,-9,36047048800,11218
488,2007,4,23,21,28,31,31,-0.178571,-5,-0.258065,-8,-0.258065,-8,36047048800,11218
488,2007,5,31,23,37,27,27,-0.162162,-6,0.148148,4,0.148148,4,36047048800,11218
488,2008,0,27,27,29,21,21,-0.068966,-2,0.285714,6,0.285714,6,36047048800,11218
488,2008,1,30,27,23,20,20,0.304348,7,0.5,10,0.5,10,36047048800,11218
488,2008,2,22,30,21,33,33,0.047619,1,-0.333333,-11,-0.333333,-11,36047048800,11218
488,2008,3,20,22,21,32,32,-0.047619,-1,-0.375,-12,-0.375,-12,36047048800,11218
488,2008,4,22,20,23,33,33,-0.043478,-1,-0.333333,-11,-0.333333,-11,36047048800,11218
488,2008,5,22,22,31,31,31,-0.290323,-9,-0.290323,-9,-0.290323,-9,36047048800,11218
488,2009,0,30,30,27,26,26,0.111111,3,0.153846,4,0.153846,4,36047048800,11218
488,2009,1,33,30,30,22,22,0.1,3,0.5,11,0.5,11,36047048800,11218
488,2009,2,37,33,22,25,25,0.681818,15,0.48,12,0.48,12,36047048800,11218
488,2009,3,35,37,20,29,29,0.75,15,0.206897,6,0.206897,6,36047048800,11218
488,2009,4,21,35,22,28,28,-0.045455,-1,-0.25,-7,-0.25,-7,36047048800,11218
488,2009,5,27,21,22,37,37,0.227273,5,-0.27027,-10,-0.27027,-10,36047048800,11218
488,2010,0,39,39,30,29,29,0.3,9,0.344828,10,0.344828,10,36047048800,11218
488,2010,1,33,39,33,23,23,0,0,0.434783,10,0.434783,10,36047048800,11218
488,2010,2,31,33,37,21,21,-0.162162,-6,0.47619,10,0.47619,10,36047048800,11218
488,2010,3,40,31,35,21,21,0.142857,5,0.904762,19,0.904762,19,36047048800,11218
488,2010,4,38,40,21,23,23,0.809524,17,0.652174,15,0.652174,15,36047048800,11218
488,2010,5,22,38,27,31,31,-0.185185,-5,-0.290323,-9,-0.290323,-9,36047048800,11218
489,2007,2,1,0,0,0,0,1,1,1,1,1,1,36047048900,11206
489,2008,2,1,0,1,0,0,0,0,1,1,1,1,36047048900,11206
490,2001,0,49,49,49,49,49,0,0,0,0,0,0,36047049000,11218
490,2001,1,46,49,46,46,46,0,0,0,0,0,0,36047049000,11218
490,2001,2,45,46,45,45,45,0,0,0,0,0,0,36047049000,11218
490,2001,3,48,45,48,48,48,0,0,0,0,0,0,36047049000,11218
490,2001,4,53,48,53,53,53,0,0,0,0,0,0,36047049000,11218
490,2001,5,51,53,51,51,51,0,0,0,0,0,0,36047049000,11218
490,2002,0,49,49,49,49,49,0,0,0,0,0,0,36047049000,11218
490,2002,1,48,49,46,48,48,0.043478,2,0,0,0,0,36047049000,11218
490,2002,2,50,48,45,50,50,0.111111,5,0,0,0,0,36047049000,11218
490,2002,3,47,50,48,47,47,-0.020833,-1,0,0,0,0,36047049000,11218
490,2002,4,40,47,53,40,40,-0.245283,-13,0,0,0,0,36047049000,11218
490,2002,5,50,40,51,50,50,-0.019608,-1,0,0,0,0,36047049000,11218
490,2003,0,39,39,49,39,39,-0.204082,-10,0,0,0,0,36047049000,11218
490,2003,1,47,39,48,47,47,-0.020833,-1,0,0,0,0,36047049000,11218
490,2003,2,50,47,50,50,50,0,0,0,0,0,0,36047049000,11218
490,2003,3,52,50,47,52,52,0.106383,5,0,0,0,0,36047049000,11218
490,2003,4,40,52,40,40,40,0,0,0,0,0,0,36047049000,11218
490,2003,5,37,40,50,37,37,-0.26,-13,0,0,0,0,36047049000,11218
490,2004,0,39,39,39,49,49,0,0,-0.204082,-10,-0.204082,-10,36047049000,11218
490,2004,1,48,39,47,46,46,0.021277,1,0.043478,2,0.043478,2,36047049000,11218
490,2004,2,46,48,50,45,45,-0.08,-4,0.022222,1,0.022222,1,36047049000,11218
490,2004,3,46,46,52,48,48,-0.115385,-6,-0.041667,-2,-0.041667,-2,36047049000,11218
490,2004,4,49,46,40,53,53,0.225,9,-0.075472,-4,-0.075472,-4,36047049000,11218
490,2004,5,42,49,37,51,51,0.135135,5,-0.176471,-9,-0.176471,-9,36047049000,11218
490,2005,0,35,35,39,49,49,-0.102564,-4,-0.285714,-14,-0.285714,-14,36047049000,11218
490,2005,1,54,35,48,48,48,0.125,6,0.125,6,0.125,6,36047049000,11218
490,2005,2,51,54,46,50,50,0.108696,5,0.02,1,0.02,1,36047049000,11218
490,2005,3,38,51,46,47,47,-0.173913,-8,-0.191489,-9,-0.191489,-9,36047049000,11218
490,2005,4,40,38,49,40,40,-0.183673,-9,0,0,0,0,36047049000,11218
490,2005,5,41,40,42,50,50,-0.02381,-1,-0.18,-9,-0.18,-9,36047049000,11218
490,2006,0,31,31,35,39,39,-0.114286,-4,-0.205128,-8,-0.205128,-8,36047049000,11218
490,2006,1,38,31,54,47,47,-0.296296,-16,-0.191489,-9,-0.191489,-9,36047049000,11218
490,2006,2,48,38,51,50,50,-0.058824,-3,-0.04,-2,-0.04,-2,36047049000,11218
490,2006,3,44,48,38,52,52,0.157895,6,-0.153846,-8,-0.153846,-8,36047049000,11218
490,2006,4,31,44,40,40,40,-0.225,-9,-0.225,-9,-0.225,-9,36047049000,11218
490,2006,5,45,31,41,37,37,0.097561,4,0.216216,8,0.216216,8,36047049000,11218
490,2007,0,33,33,31,39,39,0.064516,2,-0.153846,-6,-0.153846,-6,36047049000,11218
490,2007,1,32,33,38,48,48,-0.157895,-6,-0.333333,-16,-0.333333,-16,36047049000,11218
490,2007,2,40,32,48,46,46,-0.166667,-8,-0.130435,-6,-0.130435,-6,36047049000,11218
490,2007,3,47,40,44,46,46,0.068182,3,0.021739,1,0.021739,1,36047049000,11218
490,2007,4,43,47,31,49,49,0.387097,12,-0.122449,-6,-0.122449,-6,36047049000,11218
490,2007,5,29,43,45,42,42,-0.355556,-16,-0.309524,-13,-0.309524,-13,36047049000,11218
490,2008,0,38,38,33,35,35,0.151515,5,0.085714,3,0.085714,3,36047049000,11218
490,2008,1,39,38,32,54,54,0.21875,7,-0.277778,-15,-0.277778,-15,36047049000,11218
490,2008,2,31,39,40,51,51,-0.225,-9,-0.392157,-20,-0.392157,-20,36047049000,11218
490,2008,3,39,31,47,38,38,-0.170213,-8,0.026316,1,0.026316,1,36047049000,11218
490,2008,4,46,39,43,40,40,0.069767,3,0.15,6,0.15,6,36047049000,11218
490,2008,5,41,46,29,41,41,0.413793,12,0,0,0,0,36047049000,11218
490,2009,0,39,39,38,31,31,0.026316,1,0.258065,8,0.258065,8,36047049000,11218
490,2009,1,52,39,39,38,38,0.333333,13,0.368421,14,0.368421,14,36047049000,11218
490,2009,2,41,52,31,48,48,0.322581,10,-0.145833,-7,-0.145833,-7,36047049000,11218
490,2009,3,35,41,39,44,44,-0.102564,-4,-0.204545,-9,-0.204545,-9,36047049000,11218
490,2009,4,43,35,46,31,31,-0.065217,-3,0.387097,12,0.387097,12,36047049000,11218
490,2009,5,52,43,41,45,45,0.268293,11,0.155556,7,0.155556,7,36047049000,11218
490,2010,0,39,39,39,33,33,0,0,0.181818,6,0.181818,6,36047049000,11218
490,2010,1,44,39,52,32,32,-0.153846,-8,0.375,12,0.375,12,36047049000,11218
490,2010,2,53,44,41,40,40,0.292683,12,0.325,13,0.325,13,36047049000,11218
490,2010,3,44,53,35,47,47,0.257143,9,-0.06383,-3,-0.06383,-3,36047049000,11218
490,2010,4,42,44,43,43,43,-0.023256,-1,-0.023256,-1,-0.023256,-1,36047049000,11218
490,2010,5,44,42,52,29,29,-0.153846,-8,0.517241,15,0.517241,15,36047049000,11218
492,2001,0,10,10,10,10,10,0,0,0,0,0,0,36047049200,11218
492,2001,1,12,10,12,12,12,0,0,0,0,0,0,36047049200,11218
492,2001,2,5,12,5,5,5,0,0,0,0,0,0,36047049200,11218
492,2001,3,17,5,17,17,17,0,0,0,0,0,0,36047049200,11218
492,2001,4,12,17,12,12,12,0,0,0,0,0,0,36047049200,11218
492,2001,5,10,12,10,10,10,0,0,0,0,0,0,36047049200,11218
492,2002,0,12,12,10,12,12,0.2,2,0,0,0,0,36047049200,11218
492,2002,1,20,12,12,20,20,0.666667,8,0,0,0,0,36047049200,11218
492,2002,2,14,20,5,14,14,1.8,9,0,0,0,0,36047049200,11218
492,2002,3,9,14,17,9,9,-0.470588,-8,0,0,0,0,36047049200,11218
492,2002,4,18,9,12,18,18,0.5,6,0,0,0,0,36047049200,11218
492,2002,5,18,18,10,18,18,0.8,8,0,0,0,0,36047049200,11218
492,2003,0,20,20,12,20,20,0.666667,8,0,0,0,0,36047049200,11218
492,2003,1,12,20,20,12,12,-0.4,-8,0,0,0,0,36047049200,11218
492,2003,2,22,12,14,22,22,0.571429,8,0,0,0,0,36047049200,11218
492,2003,3,11,22,9,11,11,0.222222,2,0,0,0,0,36047049200,11218
492,2003,4,11,11,18,11,11,-0.388889,-7,0,0,0,0,36047049200,11218
492,2003,5,15,11,18,15,15,-0.166667,-3,0,0,0,0,36047049200,11218
492,2004,0,8,8,20,10,10,-0.6,-12,-0.2,-2,-0.2,-2,36047049200,11218
492,2004,1,19,8,12,12,12,0.583333,7,0.583333,7,0.583333,7,36047049200,11218
492,2004,2,12,19,22,5,5,-0.454545,-10,1.4,7,1.4,7,36047049200,11218
492,2004,3,24,12,11,17,17,1.181818,13,0.411765,7,0.411765,7,36047049200,11218
492,2004,4,13,24,11,12,12,0.181818,2,0.083333,1,0.083333,1,36047049200,11218
492,2004,5,12,13,15,10,10,-0.2,-3,0.2,2,0.2,2,36047049200,11218
492,2005,0,19,19,8,12,12,1.375,11,0.583333,7,0.583333,7,36047049200,11218
492,2005,1,12,19,19,20,20,-0.368421,-7,-0.4,-8,-0.4,-8,36047049200,11218
492,2005,2,19,12,12,14,14,0.583333,7,0.357143,5,0.357143,5,36047049200,11218
492,2005,3,11,19,24,9,9,-0.541667,-13,0.222222,2,0.222222,2,36047049200,11218
492,2005,4,15,11,13,18,18,0.153846,2,-0.166667,-3,-0.166667,-3,36047049200,11218
492,2005,5,10,15,12,18,18,-0.166667,-2,-0.444444,-8,-0.444444,-8,36047049200,11218
492,2006,0,11,11,19,20,20,-0.421053,-8,-0.45,-9,-0.45,-9,36047049200,11218
492,2006,1,19,11,12,12,12,0.583333,7,0.583333,7,0.583333,7,36047049200,11218
492,2006,2,14,19,19,22,22,-0.263158,-5,-0.363636,-8,-0.363636,-8,36047049200,11218
492,2006,3,16,14,11,11,11,0.454545,5,0.454545,5,0.454545,5,36047049200,11218
492,2006,4,12,16,15,11,11,-0.2,-3,0.090909,1,0.090909,1,36047049200,11218
492,2006,5,21,12,10,15,15,1.1,11,0.4,6,0.4,6,36047049200,11218
492,2007,0,15,15,11,8,8,0.363636,4,0.875,7,0.875,7,36047049200,11218
492,2007,1,7,15,19,19,19,-0.631579,-12,-0.631579,-12,-0.631579,-12,36047049200,11218
492,2007,2,20,7,14,12,12,0.428571,6,0.666667,8,0.666667,8,36047049200,11218
492,2007,3,12,20,16,24,24,-0.25,-4,-0.5,-12,-0.5,-12,36047049200,11218
492,2007,4,18,12,12,13,13,0.5,6,0.384615,5,0.384615,5,36047049200,11218
492,2007,5,17,18,21,12,12,-0.190476,-4,0.416667,5,0.416667,5,36047049200,11218
492,2008,0,21,21,15,19,19,0.4,6,0.105263,2,0.105263,2,36047049200,11218
492,2008,1,16,21,7,12,12,1.285714,9,0.333333,4,0.333333,4,36047049200,11218
492,2008,2,10,16,20,19,19,-0.5,-10,-0.473684,-9,-0.473684,-9,36047049200,11218
492,2008,3,18,10,12,11,11,0.5,6,0.636364,7,0.636364,7,36047049200,11218
492,2008,4,12,18,18,15,15,-0.333333,-6,-0.2,-3,-0.2,-3,36047049200,11218
492,2008,5,17,12,17,10,10,0,0,0.7,7,0.7,7,36047049200,11218
492,2009,0,10,10,21,11,11,-0.52381,-11,-0.090909,-1,-0.090909,-1,36047049200,11218
492,2009,1,22,10,16,19,19,0.375,6,0.157895,3,0.157895,3,36047049200,11218
492,2009,2,16,22,10,14,14,0.6,6,0.142857,2,0.142857,2,36047049200,11218
492,2009,3,13,16,18,16,16,-0.277778,-5,-0.1875,-3,-0.1875,-3,36047049200,11218
492,2009,4,16,13,12,12,12,0.333333,4,0.333333,4,0.333333,4,36047049200,11218
492,2009,5,15,16,17,21,21,-0.117647,-2,-0.285714,-6,-0.285714,-6,36047049200,11218
492,2010,0,17,17,10,15,15,0.7,7,0.133333,2,0.133333,2,36047049200,11218
492,2010,1,10,17,22,7,7,-0.545455,-12,0.428571,3,0.428571,3,36047049200,11218
492,2010,2,22,10,16,20,20,0.375,6,0.1,2,0.1,2,36047049200,11218
492,2010,3,13,22,13,12,12,0,0,0.083333,1,0.083333,1,36047049200,11218
492,2010,4,13,13,16,18,18,-0.1875,-3,-0.277778,-5,-0.277778,-5,36047049200,11218
492,2010,5,16,13,15,17,17,0.066667,1,-0.058824,-1,-0.058824,-1,36047049200,11218
494,2001,0,23,23,23,23,23,0,0,0,0,0,0,36047049400,11218
494,2001,1,31,23,31,31,31,0,0,0,0,0,0,36047049400,11218
494,2001,2,23,31,23,23,23,0,0,0,0,0,0,36047049400,11218
494,2001,3,24,23,24,24,24,0,0,0,0,0,0,36047049400,11218
494,2001,4,38,24,38,38,38,0,0,0,0,0,0,36047049400,11218
494,2001,5,33,38,33,33,33,0,0,0,0,0,0,36047049400,11218
494,2002,0,24,24,23,24,24,0.043478,1,0,0,0,0,36047049400,11218
494,2002,1,25,24,31,25,25,-0.193548,-6,0,0,0,0,36047049400,11218
494,2002,2,29,25,23,29,29,0.26087,6,0,0,0,0,36047049400,11218
494,2002,3,22,29,24,22,22,-0.083333,-2,0,0,0,0,36047049400,11218
494,2002,4,25,22,38,25,25,-0.342105,-13,0,0,0,0,36047049400,11218
494,2002,5,36,25,33,36,36,0.090909,3,0,0,0,0,36047049400,11218
494,2003,0,20,20,24,20,20,-0.166667,-4,0,0,0,0,36047049400,11218
494,2003,1,20,20,25,20,20,-0.2,-5,0,0,0,0,36047049400,11218
494,2003,2,27,20,29,27,27,-0.068966,-2,0,0,0,0,36047049400,11218
494,2003,3,27,27,22,27,27,0.227273,5,0,0,0,0,36047049400,11218
494,2003,4,25,27,25,25,25,0,0,0,0,0,0,36047049400,11218
494,2003,5,25,25,36,25,25,-0.305556,-11,0,0,0,0,36047049400,11218
494,2004,0,19,19,20,23,23,-0.05,-1,-0.173913,-4,-0.173913,-4,36047049400,11218
494,2004,1,17,19,20,31,31,-0.15,-3,-0.451613,-14,-0.451613,-14,36047049400,11218
494,2004,2,22,17,27,23,23,-0.185185,-5,-0.043478,-1,-0.043478,-1,36047049400,11218
494,2004,3,28,22,27,24,24,0.037037,1,0.166667,4,0.166667,4,36047049400,11218
494,2004,4,23,28,25,38,38,-0.08,-2,-0.394737,-15,-0.394737,-15,36047049400,11218
494,2004,5,29,23,25,33,33,0.16,4,-0.121212,-4,-0.121212,-4,36047049400,11218
494,2005,0,22,22,19,24,24,0.157895,3,-0.083333,-2,-0.083333,-2,36047049400,11218
494,2005,1,20,22,17,25,25,0.176471,3,-0.2,-5,-0.2,-5,36047049400,11218
494,2005,2,15,20,22,29,29,-0.318182,-7,-0.482759,-14,-0.482759,-14,36047049400,11218
494,2005,3,24,15,28,22,22,-0.142857,-4,0.090909,2,0.090909,2,36047049400,11218
494,2005,4,23,24,23,25,25,0,0,-0.08,-2,-0.08,-2,36047049400,11218
494,2005,5,24,23,29,36,36,-0.172414,-5,-0.333333,-12,-0.333333,-12,36047049400,11218
494,2006,0,20,20,22,20,20,-0.090909,-2,0,0,0,0,36047049400,11218
494,2006,1,23,20,20,20,20,0.15,3,0.15,3,0.15,3,36047049400,11218
494,2006,2,21,23,15,27,27,0.4,6,-0.222222,-6,-0.222222,-6,36047049400,11218
494,2006,3,17,21,24,27,27,-0.291667,-7,-0.37037,-10,-0.37037,-10,36047049400,11218
494,2006,4,22,17,23,25,25,-0.043478,-1,-0.12,-3,-0.12,-3,36047049400,11218
494,2006,5,30,22,24,25,25,0.25,6,0.2,5,0.2,5,36047049400,11218
494,2007,0,15,15,20,19,19,-0.25,-5,-0.210526,-4,-0.210526,-4,36047049400,11218
494,2007,1,22,15,23,17,17,-0.043478,-1,0.294118,5,0.294118,5,36047049400,11218
494,2007,2,24,22,21,22,22,0.142857,3,0.090909,2,0.090909,2,36047049400,11218
494,2007,3,22,24,17,28,28,0.294118,5,-0.214286,-6,-0.214286,-6,36047049400,11218
494,2007,4,14,22,22,23,23,-0.363636,-8,-0.391304,-9,-0.391304,-9,36047049400,11218
494,2007,5,25,14,30,29,29,-0.166667,-5,-0.137931,-4,-0.137931,-4,36047049400,11218
494,2008,0,18,18,15,22,22,0.2,3,-0.181818,-4,-0.181818,-4,36047049400,11218
494,2008,1,17,18,22,20,20,-0.227273,-5,-0.15,-3,-0.15,-3,36047049400,11218
494,2008,2,24,17,24,15,15,0,0,0.6,9,0.6,9,36047049400,11218
494,2008,3,24,24,22,24,24,0.090909,2,0,0,0,0,36047049400,11218
494,2008,4,19,24,14,23,23,0.357143,5,-0.173913,-4,-0.173913,-4,36047049400,11218
494,2008,5,14,19,25,24,24,-0.44,-11,-0.416667,-10,-0.416667,-10,36047049400,11218
494,2009,0,22,22,18,20,20,0.222222,4,0.1,2,0.1,2,36047049400,11218
494,2009,1,26,22,17,23,23,0.529412,9,0.130435,3,0.130435,3,36047049400,11218
494,2009,2,20,26,24,21,21,-0.166667,-4,-0.047619,-1,-0.047619,-1,36047049400,11218
494,2009,3,28,20,24,17,17,0.166667,4,0.647059,11,0.647059,11,36047049400,11218
494,2009,4,21,28,19,22,22,0.105263,2,-0.045455,-1,-0.045455,-1,36047049400,11218
494,2009,5,21,21,14,30,30,0.5,7,-0.3,-9,-0.3,-9,36047049400,11218
494,2010,0,30,30,22,15,15,0.363636,8,1,15,1,15,36047049400,11218
494,2010,1,25,30,26,22,22,-0.038462,-1,0.136364,3,0.136364,3,36047049400,11218
494,2010,2,26,25,20,24,24,0.3,6,0.083333,2,0.083333,2,36047049400,11218
494,2010,3,19,26,28,22,22,-0.321429,-9,-0.136364,-3,-0.136364,-3,36047049400,11218
494,2010,4,30,19,21,14,14,0.428571,9,1.142857,16,1.142857,16,36047049400,11218
494,2010,5,21,30,21,25,25,0,0,-0.16,-4,-0.16,-4,36047049400,11218
726,2002,5,1,0,0,1,1,1,1,0,0,0,0,36047072600,11203
902,2006,0,1,1,0,0,0,1,1,1,1,1,1,36047090200,11212
906,2007,1,1,0,0,0,0,1,1,1,1,1,1,36047090600,11212
906,2008,2,1,0,0,0,0,1,1,1,1,1,1,36047090600,11212
1144,2006,1,1,0,0,0,0,1,1,1,1,1,1,,
5201,2001,0,4,4,4,4,4,0,0,0,0,0,0,36047005201,11209
5201,2001,1,4,4,4,4,4,0,0,0,0,0,0,36047005201,11209
5201,2001,2,3,4,3,3,3,0,0,0,0,0,0,36047005201,11209
5201,2001,3,4,3,4,4,4,0,0,0,0,0,0,36047005201,11209
5201,2001,4,8,4,8,8,8,0,0,0,0,0,0,36047005201,11209
5201,2001,5,6,8,6,6,6,0,0,0,0,0,0,36047005201,11209
5201,2002,0,7,7,4,7,7,0.75,3,0,0,0,0,36047005201,11209
5201,2002,1,4,7,4,4,4,0,0,0,0,0,0,36047005201,11209
5201,2002,2,4,4,3,4,4,0.333333,1,0,0,0,0,36047005201,11209
5201,2002,3,3,4,4,3,3,-0.25,-1,0,0,0,0,36047005201,11209
5201,2002,4,4,3,8,4,4,-0.5,-4,0,0,0,0,36047005201,11209
5201,2002,5,9,4,6,9,9,0.5,3,0,0,0,0,36047005201,11209
5201,2003,0,5,5,7,5,5,-0.285714,-2,0,0,0,0,36047005201,11209
5201,2003,1,8,5,4,8,8,1,4,0,0,0,0,36047005201,11209
5201,2003,2,3,8,4,3,3,-0.25,-1,0,0,0,0,36047005201,11209
5201,2003,3,3,3,3,3,3,0,0,0,0,0,0,36047005201,11209
5201,2003,4,5,3,4,5,5,0.25,1,0,0,0,0,36047005201,11209
5201,2003,5,5,5,9,5,5,-0.444444,-4,0,0,0,0,36047005201,11209
5201,2004,0,3,3,5,4,4,-0.4,-2,-0.25,-1,-0.25,-1,36047005201,11209
5201,2004,1,5,3,8,4,4,-0.375,-3,0.25,1,0.25,1,36047005201,11209
5201,2004,2,8,5,3,3,3,1.666667,5,1.666667,5,1.666667,5,36047005201,11209
5201,2004,3,3,8,3,4,4,0,0,-0.25,-1,-0.25,-1,36047005201,11209
5201,2004,4,3,3,5,8,8,-0.4,-2,-0.625,-5,-0.625,-5,36047005201,11209
5201,2004,5,5,3,5,6,6,0,0,-0.166667,-1,-0.166667,-1,36047005201,11209
5201,2005,0,3,3,3,7,7,0,0,-0.571429,-4,-0.571429,-4,36047005201,11209
5201,2005,1,3,3,5,4,4,-0.4,-2,-0.25,-1,-0.25,-1,36047005201,11209
5201,2005,2,4,3,8,4,4,-0.5,-4,0,0,0,0,36047005201,11209
5201,2005,3,7,4,3,3,3,1.333333,4,1.333333,4,1.333333,4,36047005201,11209
5201,2005,4,3,7,3,4,4,0,0,-0.25,-1,-0.25,-1,36047005201,11209
5201,2005,5,5,3,5,9,9,0,0,-0.444444,-4,-0.444444,-4,36047005201,11209
5201,2006,0,4,4,3,5,5,0.333333,1,-0.2,-1,-0.2,-1,36047005201,11209
5201,2006,1,4,4,3,8,8,0.333333,1,-0.5,-4,-0.5,-4,36047005201,11209
5201,2006,2,3,4,4,3,3,-0.25,-1,0,0,0,0,36047005201,11209
5201,2006,3,5,3,7,3,3,-0.285714,-2,0.666667,2,0.666667,2,36047005201,11209
5201,2006,4,8,5,3,5,5,1.666667,5,0.6,3,0.6,3,36047005201,11209
5201,2006,5,3,8,5,5,5,-0.4,-2,-0.4,-2,-0.4,-2,36047005201,11209
5201,2007,0,6,6,4,3,3,0.5,2,1,3,1,3,36047005201,11209
5201,2007,1,6,6,4,5,5,0.5,2,0.2,1,0.2,1,36047005201,11209
5201,2007,2,3,6,3,8,8,0,0,-0.625,-5,-0.625,-5,36047005201,11209
5201,2007,3,1,3,5,3,3,-0.8,-4,-0.666667,-2,-0.666667,-2,36047005201,11209
5201,2007,4,7,1,8,3,3,-0.125,-1,1.333333,4,1.333333,4,36047005201,11209
5201,2007,5,7,7,3,5,5,1.333333,4,0.4,2,0.4,2,36047005201,11209
5201,2008,0,3,3,6,3,3,-0.5,-3,0,0,0,0,36047005201,11209
5201,2008,1,7,3,6,3,3,0.166667,1,1.333333,4,1.333333,4,36047005201,11209
5201,2008,2,4,7,3,4,4,0.333333,1,0,0,0,0,36047005201,11209
5201,2008,3,3,4,1,7,7,2,2,-0.571429,-4,-0.571429,-4,36047005201,11209
5201,2008,4,1,3,7,3,3,-0.857143,-6,-0.666667,-2,-0.666667,-2,36047005201,11209
5201,2008,5,6,1,7,5,5,-0.142857,-1,0.2,1,0.2,1,36047005201,11209
5201,2009,0,13,13,3,4,4,3.333333,10,2.25,9,2.25,9,36047005201,11209
5201,2009,1,4,13,7,4,4,-0.428571,-3,0,0,0,0,36047005201,11209
5201,2009,2,8,4,4,3,3,1,4,1.666667,5,1.666667,5,36047005201,11209
5201,2009,3,6,8,3,5,5,1,3,0.2,1,0.2,1,36047005201,11209
5201,2009,4,8,6,1,8,8,7,7,0,0,0,0,36047005201,11209
5201,2009,5,3,8,6,3,3,-0.5,-3,0,0,0,0,36047005201,11209
5201,2010,0,7,7,13,6,6,-0.461538,-6,0.166667,1,0.166667,1,36047005201,11209
5201,2010,1,10,7,4,6,6,1.5,6,0.666667,4,0.666667,4,36047005201,11209
5201,2010,2,4,10,8,3,3,-0.5,-4,0.333333,1,0.333333,1,36047005201,11209
5201,2010,3,7,4,6,1,1,0.166667,1,6,6,6,6,36047005201,11209
5201,2010,4,7,7,8,7,7,-0.125,-1,0,0,0,0,36047005201,11209
5201,2010,5,9,7,3,7,7,2,6,0.285714,2,0.285714,2,36047005201,11209
5202,2001,0,6,6,6,6,6,0,0,0,0,0,0,36047005202,11209
5202,2001,1,6,6,6,6,6,0,0,0,0,0,0,36047005202,11209
5202,2001,2,2,6,2,2,2,0,0,0,0,0,0,36047005202,11209
5202,2001,3,4,2,4,4,4,0,0,0,0,0,0,36047005202,11209
5202,2001,4,6,4,6,6,6,0,0,0,0,0,0,36047005202,11209
5202,2001,5,5,6,5,5,5,0,0,0,0,0,0,36047005202,11209
5202,2002,0,4,4,6,4,4,-0.333333,-2,0,0,0,0,36047005202,11209
5202,2002,1,7,4,6,7,7,0.166667,1,0,0,0,0,36047005202,11209
5202,2002,2,4,7,2,4,4,1,2,0,0,0,0,36047005202,11209
5202,2002,3,5,4,4,5,5,0.25,1,0,0,0,0,36047005202,11209
5202,2002,4,8,5,6,8,8,0.333333,2,0,0,0,0,36047005202,11209
5202,2002,5,6,8,5,6,6,0.2,1,0,0,0,0,36047005202,11209
5202,2003,0,8,8,4,8,8,1,4,0,0,0,0,36047005202,11209
5202,2003,1,5,8,7,5,5,-0.285714,-2,0,0,0,0,36047005202,11209
5202,2003,2,5,5,4,5,5,0.25,1,0,0,0,0,36047005202,11209
5202,2003,3,5,5,5,5,5,0,0,0,0,0,0,36047005202,11209
5202,2003,4,8,5,8,8,8,0,0,0,0,0,0,36047005202,11209
5202,2003,5,7,8,6,7,7,0.166667,1,0,0,0,0,36047005202,11209
5202,2004,0,8,8,8,6,6,0,0,0.333333,2,0.333333,2,36047005202,11209
5202,2004,1,10,8,5,6,6,1,5,0.666667,4,0.666667,4,36047005202,11209
5202,2004,2,5,10,5,2,2,0,0,1.5,3,1.5,3,36047005202,11209
5202,2004,3,2,5,5,4,4,-0.6,-3,-0.5,-2,-0.5,-2,36047005202,11209
5202,2004,4,7,2,8,6,6,-0.125,-1,0.166667,1,0.166667,1,36047005202,11209
5202,2004,5,5,7,7,5,5,-0.285714,-2,0,0,0,0,36047005202,11209
5202,2005,0,8,8,8,4,4,0,0,1,4,1,4,36047005202,11209
5202,2005,1,7,8,10,7,7,-0.3,-3,0,0,0,0,36047005202,11209
5202,2005,2,7,7,5,4,4,0.4,2,0.75,3,0.75,3,36047005202,11209
5202,2005,3,3,7,2,5,5,0.5,1,-0.4,-2,-0.4,-2,36047005202,11209
5202,2005,4,3,3,7,8,8,-0.571429,-4,-0.625,-5,-0.625,-5,36047005202,11209
5202,2005,5,5,3,5,6,6,0,0,-0.166667,-1,-0.166667,-1,36047005202,11209
5202,2006,0,8,8,8,8,8,0,0,0,0,0,0,36047005202,11209
5202,2006,1,4,8,7,5,5,-0.428571,-3,-0.2,-1,-0.2,-1,36047005202,11209
5202,2006,2,6,4,7,5,5,-0.142857,-1,0.2,1,0.2,1,36047005202,11209
5202,2006,3,4,6,3,5,5,0.333333,1,-0.2,-1,-0.2,-1,36047005202,11209
5202,2006,4,3,4,3,8,8,0,0,-0.625,-5,-0.625,-5,36047005202,11209
5202,2006,5,3,3,5,7,7,-0.4,-2,-0.571429,-4,-0.571429,-4,36047005202,11209
5202,2007,0,12,12,8,8,8,0.5,4,0.5,4,0.5,4,36047005202,11209
5202,2007,1,7,12,4,10,10,0.75,3,-0.3,-3,-0.3,-3,36047005202,11209
5202,2007,2,4,7,6,5,5,-0.333333,-2,-0.2,-1,-0.2,-1,36047005202,11209
5202,2007,3,5,4,4,2,2,0.25,1,1.5,3,1.5,3,36047005202,11209
5202,2007,4,1,5,3,7,7,-0.666667,-2,-0.857143,-6,-0.857143,-6,36047005202,11209
5202,2007,5,2,1,3,5,5,-0.333333,-1,-0.6,-3,-0.6,-3,36047005202,11209
5202,2008,0,12,12,12,8,8,0,0,0.5,4,0.5,4,36047005202,11209
5202,2008,1,9,12,7,7,7,0.285714,2,0.285714,2,0.285714,2,36047005202,11209
5202,2008,2,3,9,4,7,7,-0.25,-1,-0.571429,-4,-0.571429,-4,36047005202,11209
5202,2008,3,4,3,5,3,3,-0.2,-1,0.333333,1,0.333333,1,36047005202,11209
5202,2008,4,5,4,1,3,3,4,4,0.666667,2,0.666667,2,36047005202,11209
5202,2008,5,1,5,2,5,5,-0.5,-1,-0.8,-4,-0.8,-4,36047005202,11209
5202,2009,0,15,15,12,8,8,0.25,3,0.875,7,0.875,7,36047005202,11209
5202,2009,1,13,15,9,4,4,0.444444,4,2.25,9,2.25,9,36047005202,11209
5202,2009,2,10,13,3,6,6,2.333333,7,0.666667,4,0.666667,4,36047005202,11209
5202,2009,3,5,10,4,4,4,0.25,1,0.25,1,0.25,1,36047005202,11209
5202,2009,4,10,5,5,3,3,1,5,2.333333,7,2.333333,7,36047005202,11209
5202,2009,5,5,10,1,3,3,4,4,0.666667,2,0.666667,2,36047005202,11209
5202,2010,0,17,17,15,12,12,0.133333,2,0.416667,5,0.416667,5,36047005202,11209
5202,2010,1,13,17,13,7,7,0,0,0.857143,6,0.857143,6,36047005202,11209
5202,2010,2,15,13,10,4,4,0.5,5,2.75,11,2.75,11,36047005202,11209
5202,2010,3,10,15,5,5,5,1,5,1,5,1,5,36047005202,11209
5202,2010,4,5,10,10,1,1,-0.5,-5,4,4,4,4,36047005202,11209
5202,2010,5,10,5,5,2,2,1,5,4,8,4,8,36047005202,11209
5601,2001,0,6,6,6,6,6,0,0,0,0,0,0,36047005601,11209
5601,2001,1,11,6,11,11,11,0,0,0,0,0,0,36047005601,11209
5601,2001,2,8,11,8,8,8,0,0,0,0,0,0,36047005601,11209
5601,2001,3,7,8,7,7,7,0,0,0,0,0,0,36047005601,11209
5601,2001,4,3,7,3,3,3,0,0,0,0,0,0,36047005601,11209
5601,2001,5,6,3,6,6,6,0,0,0,0,0,0,36047005601,11209
5601,2002,0,8,8,6,8,8,0.333333,2,0,0,0,0,36047005601,11209
5601,2002,1,8,8,11,8,8,-0.272727,-3,0,0,0,0,36047005601,11209
5601,2002,2,9,8,8,9,9,0.125,1,0,0,0,0,36047005601,11209
5601,2002,3,6,9,7,6,6,-0.142857,-1,0,0,0,0,36047005601,11209
5601,2002,4,6,6,3,6,6,1,3,0,0,0,0,36047005601,11209
5601,2002,5,4,6,6,4,4,-0.333333,-2,0,0,0,0,36047005601,11209
5601,2003,0,3,3,8,3,3,-0.625,-5,0,0,0,0,36047005601,11209
5601,2003,1,5,3,8,5,5,-0.375,-3,0,0,0,0,36047005601,11209
5601,2003,2,6,5,9,6,6,-0.333333,-3,0,0,0,0,36047005601,11209
5601,2003,3,7,6,6,7,7,0.166667,1,0,0,0,0,36047005601,11209
5601,2003,4,7,7,6,7,7,0.166667,1,0,0,0,0,36047005601,11209
5601,2003,5,4,7,4,4,4,0,0,0,0,0,0,36047005601,11209
5601,2004,0,7,7,3,6,6,1.333333,4,0.166667,1,0.166667,1,36047005601,11209
5601,2004,1,2,7,5,11,11,-0.6,-3,-0.818182,-9,-0.818182,-9,36047005601,11209
5601,2004,2,4,2,6,8,8,-0.333333,-2,-0.5,-4,-0.5,-4,36047005601,11209
5601,2004,3,6,4,7,7,7,-0.142857,-1,-0.142857,-1,-0.142857,-1,36047005601,11209
5601,2004,4,6,6,7,3,3,-0.142857,-1,1,3,1,3,36047005601,11209
5601,2004,5,6,6,4,6,6,0.5,2,0,0,0,0,36047005601,11209
5601,2005,0,7,7,7,8,8,0,0,-0.125,-1,-0.125,-1,36047005601,11209
5601,2005,1,8,7,2,8,8,3,6,0,0,0,0,36047005601,11209
5601,2005,2,3,8,4,9,9,-0.25,-1,-0.666667,-6,-0.666667,-6,36047005601,11209
5601,2005,3,4,3,6,6,6,-0.333333,-2,-0.333333,-2,-0.333333,-2,36047005601,11209
5601,2005,4,6,4,6,6,6,0,0,0,0,0,0,36047005601,11209
5601,2005,5,5,6,6,4,4,-0.166667,-1,0.25,1,0.25,1,36047005601,11209
5601,2006,0,7,7,7,3,3,0,0,1.333333,4,1.333333,4,36047005601,11209
5601,2006,1,3,7,8,5,5,-0.625,-5,-0.4,-2,-0.4,-2,36047005601,11209
5601,2006,2,7,3,3,6,6,1.333333,4,0.166667,1,0.166667,1,36047005601,11209
5601,2006,3,3,7,4,7,7,-0.25,-1,-0.571429,-4,-0.571429,-4,36047005601,11209
5601,2006,4,3,3,6,7,7,-0.5,-3,-0.571429,-4,-0.571429,-4,36047005601,11209
5601,2006,5,4,3,5,4,4,-0.2,-1,0,0,0,0,36047005601,11209
5601,2007,0,1,1,7,7,7,-0.857143,-6,-0.857143,-6,-0.857143,-6,36047005601,11209
5601,2007,1,8,1,3,2,2,1.666667,5,3,6,3,6,36047005601,11209
5601,2007,2,3,8,7,4,4,-0.571429,-4,-0.25,-1,-0.25,-1,36047005601,11209
5601,2007,3,5,3,3,6,6,0.666667,2,-0.166667,-1,-0.166667,-1,36047005601,11209
5601,2007,4,3,5,3,6,6,0,0,-0.5,-3,-0.5,-3,36047005601,11209
5601,2007,5,4,3,4,6,6,0,0,-0.333333,-2,-0.333333,-2,36047005601,11209
5601,2008,0,9,9,1,7,7,8,8,0.285714,2,0.285714,2,36047005601,11209
5601,2008,1,1,9,8,8,8,-0.875,-7,-0.875,-7,-0.875,-7,36047005601,11209
5601,2008,2,6,1,3,3,3,1,3,1,3,1,3,36047005601,11209
5601,2008,3,3,6,5,4,4,-0.4,-2,-0.25,-1,-0.25,-1,36047005601,11209
5601,2008,4,4,3,3,6,6,0.333333,1,-0.333333,-2,-0.333333,-2,36047005601,11209
5601,2008,5,3,4,4,5,5,-0.25,-1,-0.4,-2,-0.4,-2,36047005601,11209
5601,2009,0,8,8,9,7,7,-0.111111,-1,0.142857,1,0.142857,1,36047005601,11209
5601,2009,1,8,8,1,3,3,7,7,1.666667,5,1.666667,5,36047005601,11209
5601,2009,2,1,8,6,7,7,-0.833333,-5,-0.857143,-6,-0.857143,-6,36047005601,11209
5601,2009,3,6,1,3,3,3,1,3,1,3,1,3,36047005601,11209
5601,2009,4,4,6,4,3,3,0,0,0.333333,1,0.333333,1,36047005601,11209
5601,2009,5,3,4,3,4,4,0,0,-0.25,-1,-0.25,-1,36047005601,11209
5601,2010,0,9,9,8,1,1,0.125,1,8,8,8,8,36047005601,11209
5601,2010,1,4,9,8,8,8,-0.5,-4,-0.5,-4,-0.5,-4,36047005601,11209
5601,2010,2,11,4,1,3,3,10,10,2.666667,8,2.666667,8,36047005601,11209
5601,2010,4,4,0,4,3,3,0,0,0.333333,1,0.333333,1,36047005601,11209
5601,2010,5,4,4,3,4,4,0.333333,1,0,0,0,0,36047005601,11209
5602,2001,0,1,1,1,1,1,0,0,0,0,0,0,36047005602,11209
5602,2001,1,6,1,6,6,6,0,0,0,0,0,0,36047005602,11209
5602,2001,2,6,6,6,6,6,0,0,0,0,0,0,36047005602,11209
5602,2001,3,3,6,3,3,3,0,0,0,0,0,0,36047005602,11209
5602,2001,4,2,3,2,2,2,0,0,0,0,0,0,36047005602,11209
5602,2001,5,2,2,2,2,2,0,0,0,0,0,0,36047005602,11209
5602,2002,0,4,4,1,4,4,3,3,0,0,0,0,36047005602,11209
5602,2002,1,2,4,6,2,2,-0.666667,-4,0,0,0,0,36047005602,11209
5602,2002,2,5,2,6,5,5,-0.166667,-1,0,0,0,0,36047005602,11209
5602,2002,3,4,5,3,4,4,0.333333,1,0,0,0,0,36047005602,11209
5602,2002,4,2,4,2,2,2,0,0,0,0,0,0,36047005602,11209
5602,2002,5,1,2,2,1,1,-0.5,-1,0,0,0,0,36047005602,11209
5602,2003,0,3,3,4,3,3,-0.25,-1,0,0,0,0,36047005602,11209
5602,2003,1,4,3,2,4,4,1,2,0,0,0,0,36047005602,11209
5602,2003,2,3,4,5,3,3,-0.4,-2,0,0,0,0,36047005602,11209
5602,2003,3,6,3,4,6,6,0.5,2,0,0,0,0,36047005602,11209
5602,2003,4,3,6,2,3,3,0.5,1,0,0,0,0,36047005602,11209
5602,2004,1,3,0,4,6,6,-0.25,-1,-0.5,-3,-0.5,-3,36047005602,11209
5602,2004,2,4,3,3,6,6,0.333333,1,-0.333333,-2,-0.333333,-2,36047005602,11209
5602,2004,3,2,4,6,3,3,-0.666667,-4,-0.333333,-1,-0.333333,-1,36047005602,11209
5602,2004,4,4,2,3,2,2,0.333333,1,1,2,1,2,36047005602,11209
5602,2004,5,3,4,2,2,2,0.5,1,0.5,1,0.5,1,36047005602,11209
5602,2005,0,5,5,4,4,4,0.25,1,0.25,1,0.25,1,36047005602,11209
5602,2005,2,3,0,4,5,5,-0.25,-1,-0.4,-2,-0.4,-2,36047005602,11209
5602,2005,3,3,3,2,4,4,0.5,1,-0.25,-1,-0.25,-1,36047005602,11209
5602,2005,4,1,3,4,2,2,-0.75,-3,-0.5,-1,-0.5,-1,36047005602,11209
5602,2005,5,3,1,3,1,1,0,0,2,2,2,2,36047005602,11209
5602,2006,0,4,4,5,3,3,-0.2,-1,0.333333,1,0.333333,1,36047005602,11209
5602,2006,1,5,4,4,4,4,0.25,1,0.25,1,0.25,1,36047005602,11209
5602,2006,2,1,5,3,3,3,-0.666667,-2,-0.666667,-2,-0.666667,-2,36047005602,11209
5602,2006,3,3,1,3,6,6,0,0,-0.5,-3,-0.5,-3,36047005602,11209
5602,2006,4,3,3,1,3,3,2,2,0,0,0,0,36047005602,11209
5602,2006,5,1,3,3,0,0,-0.666667,-2,1,1,1,1,36047005602,11209
5602,2007,0,4,4,4,0,0,0,0,1,4,1,4,36047005602,11209
5602,2007,1,4,4,5,3,3,-0.2,-1,0.333333,1,0.333333,1,36047005602,11209
5602,2007,2,4,4,1,4,4,3,3,0,0,0,0,36047005602,11209
5602,2007,3,1,4,3,2,2,-0.666667,-2,-0.5,-1,-0.5,-1,36047005602,11209
5602,2007,4,3,1,3,4,4,0,0,-0.25,-1,-0.25,-1,36047005602,11209
5602,2007,5,3,3,1,3,3,2,2,0,0,0,0,36047005602,11209
5602,2008,0,4,4,4,5,5,0,0,-0.2,-1,-0.2,-1,36047005602,11209
5602,2008,1,5,4,4,0,0,0.25,1,1,5,1,5,36047005602,11209
5602,2008,2,4,5,4,3,3,0,0,0.333333,1,0.333333,1,36047005602,11209
5602,2008,3,3,4,1,3,3,2,2,0,0,0,0,36047005602,11209
5602,2008,4,1,3,3,1,1,-0.666667,-2,0,0,0,0,36047005602,11209
5602,2008,5,3,1,3,3,3,0,0,0,0,0,0,36047005602,11209
5602,2009,0,3,3,4,4,4,-0.25,-1,-0.25,-1,-0.25,-1,36047005602,11209
5602,2009,1,8,3,5,5,5,0.6,3,0.6,3,0.6,3,36047005602,11209
5602,2009,2,2,8,4,1,1,-0.5,-2,1,1,1,1,36047005602,11209
5602,2009,3,5,2,3,3,3,0.666667,2,0.666667,2,0.666667,2,36047005602,11209
5602,2009,4,3,5,1,3,3,2,2,0,0,0,0,36047005602,11209
5602,2009,5,2,3,3,1,1,-0.333333,-1,1,1,1,1,36047005602,11209
5602,2010,0,6,6,3,4,4,1,3,0.5,2,0.5,2,36047005602,11209
5602,2010,1,3,6,8,4,4,-0.625,-5,-0.25,-1,-0.25,-1,36047005602,11209
5602,2010,2,8,3,2,4,4,3,6,1,4,1,4,36047005602,11209
5602,2010,3,2,8,5,1,1,-0.6,-3,1,1,1,1,36047005602,11209
5602,2010,4,2,2,3,3,3,-0.333333,-1,-0.333333,-1,-0.333333,-1,36047005602,11209
5602,2010,5,3,2,2,3,3,0.5,1,0,0,0,0,36047005602,11209
12801,2001,0,26,26,26,26,26,0,0,0,0,0,0,36047012801,11219
12801,2001,1,17,26,17,17,17,0,0,0,0,0,0,36047012801,11219
12801,2001,2,26,17,26,26,26,0,0,0,0,0,0,36047012801,11219
12801,2001,3,23,26,23,23,23,0,0,0,0,0,0,36047012801,11219
12801,2001,4,22,23,22,22,22,0,0,0,0,0,0,36047012801,11219
12801,2001,5,22,22,22,22,22,0,0,0,0,0,0,36047012801,11219
12801,2002,0,13,13,26,13,13,-0.5,-13,0,0,0,0,36047012801,11219
12801,2002,1,26,13,17,26,26,0.529412,9,0,0,0,0,36047012801,11219
12801,2002,2,17,26,26,17,17,-0.346154,-9,0,0,0,0,36047012801,11219
12801,2002,3,21,17,23,21,21,-0.086957,-2,0,0,0,0,36047012801,11219
12801,2002,4,24,21,22,24,24,0.090909,2,0,0,0,0,36047012801,11219
12801,2002,5,23,24,22,23,23,0.045455,1,0,0,0,0,36047012801,11219
12801,2003,0,10,10,13,10,10,-0.230769,-3,0,0,0,0,36047012801,11219
12801,2003,1,14,10,26,14,14,-0.461538,-12,0,0,0,0,36047012801,11219
12801,2003,2,23,14,17,23,23,0.352941,6,0,0,0,0,36047012801,11219
12801,2003,3,20,23,21,20,20,-0.047619,-1,0,0,0,0,36047012801,11219
12801,2003,4,23,20,24,23,23,-0.041667,-1,0,0,0,0,36047012801,11219
12801,2003,5,20,23,23,20,20,-0.130435,-3,0,0,0,0,36047012801,11219
12801,2004,0,21,21,10,26,26,1.1,11,-0.192308,-5,-0.192308,-5,36047012801,11219
12801,2004,1,13,21,14,17,17,-0.071429,-1,-0.235294,-4,-0.235294,-4,36047012801,11219
12801,2004,2,13,13,23,26,26,-0.434783,-10,-0.5,-13,-0.5,-13,36047012801,11219
12801,2004,3,25,13,20,23,23,0.25,5,0.086957,2,0.086957,2,36047012801,11219
12801,2004,4,20,25,23,22,22,-0.130435,-3,-0.090909,-2,-0.090909,-2,36047012801,11219
12801,2004,5,23,20,20,22,22,0.15,3,0.045455,1,0.045455,1,36047012801,11219
12801,2005,0,19,19,21,13,13,-0.095238,-2,0.461538,6,0.461538,6,36047012801,11219
12801,2005,1,27,19,13,26,26,1.076923,14,0.038462,1,0.038462,1,36047012801,11219
12801,2005,2,14,27,13,17,17,0.076923,1,-0.176471,-3,-0.176471,-3,36047012801,11219
12801,2005,3,15,14,25,21,21,-0.4,-10,-0.285714,-6,-0.285714,-6,36047012801,11219
12801,2005,4,23,15,20,24,24,0.15,3,-0.041667,-1,-0.041667,-1,36047012801,11219
12801,2005,5,22,23,23,23,23,-0.043478,-1,-0.043478,-1,-0.043478,-1,36047012801,11219
12801,2006,0,20,20,19,10,10,0.052632,1,1,10,1,10,36047012801,11219
12801,2006,1,17,20,27,14,14,-0.37037,-10,0.214286,3,0.214286,3,36047012801,11219
12801,2006,2,26,17,14,23,23,0.857143,12,0.130435,3,0.130435,3,36047012801,11219
12801,2006,3,14,26,15,20,20,-0.066667,-1,-0.3,-6,-0.3,-6,36047012801,11219
12801,2006,4,15,14,23,23,23,-0.347826,-8,-0.347826,-8,-0.347826,-8,36047012801,11219
12801,2006,5,27,15,22,20,20,0.227273,5,0.35,7,0.35,7,36047012801,11219
12801,2007,0,17,17,20,21,21,-0.15,-3,-0.190476,-4,-0.190476,-4,36047012801,11219
12801,2007,1,22,17,17,13,13,0.294118,5,0.692308,9,0.692308,9,36047012801,11219
12801,2007,2,21,22,26,13,13,-0.192308,-5,0.615385,8,0.615385,8,36047012801,11219
12801,2007,3,24,21,14,25,25,0.714286,10,-0.04,-1,-0.04,-1,36047012801,11219
12801,2007,4,13,24,15,20,20,-0.133333,-2,-0.35,-7,-0.35,-7,36047012801,11219
12801,2007,5,15,13,27,23,23,-0.444444,-12,-0.347826,-8,-0.347826,-8,36047012801,11219
12801,2008,0,19,19,17,19,19,0.117647,2,0,0,0,0,36047012801,11219
12801,2008,1,20,19,22,27,27,-0.090909,-2,-0.259259,-7,-0.259259,-7,36047012801,11219
12801,2008,2,25,20,21,14,14,0.190476,4,0.785714,11,0.785714,11,36047012801,11219
12801,2008,3,19,25,24,15,15,-0.208333,-5,0.266667,4,0.266667,4,36047012801,11219
12801,2008,4,25,19,13,23,23,0.923077,12,0.086957,2,0.086957,2,36047012801,11219
12801,2008,5,16,25,15,22,22,0.066667,1,-0.272727,-6,-0.272727,-6,36047012801,11219
12801,2009,0,11,11,19,20,20,-0.421053,-8,-0.45,-9,-0.45,-9,36047012801,11219
12801,2009,1,24,11,20,17,17,0.2,4,0.411765,7,0.411765,7,36047012801,11219
12801,2009,2,24,24,25,26,26,-0.04,-1,-0.076923,-2,-0.076923,-2,36047012801,11219
12801,2009,3,26,24,19,14,14,0.368421,7,0.857143,12,0.857143,12,36047012801,11219
12801,2009,4,20,26,25,15,15,-0.2,-5,0.333333,5,0.333333,5,36047012801,11219
12801,2009,5,21,20,16,27,27,0.3125,5,-0.222222,-6,-0.222222,-6,36047012801,11219
12801,2010,0,20,20,11,17,17,0.818182,9,0.176471,3,0.176471,3,36047012801,11219
12801,2010,1,15,20,24,22,22,-0.375,-9,-0.318182,-7,-0.318182,-7,36047012801,11219
12801,2010,2,23,15,24,21,21,-0.041667,-1,0.095238,2,0.095238,2,36047012801,11219
12801,2010,3,21,23,26,24,24,-0.192308,-5,-0.125,-3,-0.125,-3,36047012801,11219
12801,2010,4,25,21,20,13,13,0.25,5,0.923077,12,0.923077,12,36047012801,11219
12801,2010,5,18,25,21,15,15,-0.142857,-3,0.2,3,0.2,3,36047012801,11219
46201,2001,0,4,4,4,4,4,0,0,0,0,0,0,36047046201,11230
46201,2001,1,2,4,2,2,2,0,0,0,0,0,0,36047046201,11230
46201,2001,2,2,2,2,2,2,0,0,0,0,0,0,36047046201,11230
46201,2001,4,1,0,1,1,1,0,0,0,0,0,0,36047046201,11230
46201,2001,5,1,1,1,1,1,0,0,0,0,0,0,36047046201,11230
46201,2002,0,1,1,4,1,1,-0.75,-3,0,0,0,0,36047046201,11230
46201,2002,1,4,1,2,4,4,1,2,0,0,0,0,36047046201,11230
46201,2002,2,2,4,2,2,2,0,0,0,0,0,0,36047046201,11230
46201,2002,3,2,2,0,2,2,1,2,0,0,0,0,36047046201,11230
46201,2002,5,2,0,1,2,2,1,1,0,0,0,0,36047046201,11230
46201,2003,0,1,1,1,1,1,0,0,0,0,0,0,36047046201,11230
46201,2003,1,1,1,4,1,1,-0.75,-3,0,0,0,0,36047046201,11230
46201,2003,2,2,1,2,2,2,0,0,0,0,0,0,36047046201,11230
46201,2003,3,2,2,2,2,2,0,0,0,0,0,0,36047046201,11230
46201,2003,4,2,2,0,2,2,1,2,0,0,0,0,36047046201,11230
46201,2004,0,1,1,1,4,4,0,0,-0.75,-3,-0.75,-3,36047046201,11230
46201,2004,1,1,1,1,2,2,0,0,-0.5,-1,-0.5,-1,36047046201,11230
46201,2004,2,1,1,2,2,2,-0.5,-1,-0.5,-1,-0.5,-1,36047046201,11230
46201,2004,3,1,1,2,0,0,-0.5,-1,1,1,1,1,36047046201,11230
46201,2004,4,2,1,2,1,1,0,0,1,1,1,1,36047046201,11230
46201,2004,5,1,2,1,1,1,0,0,0,0,0,0,36047046201,11230
46201,2005,0,2,2,1,1,1,1,1,1,1,1,1,36047046201,11230
46201,2005,1,1,2,1,4,4,0,0,-0.75,-3,-0.75,-3,36047046201,11230
46201,2005,5,1,0,1,2,2,0,0,-0.5,-1,-0.5,-1,36047046201,11230
46201,2006,1,1,0,1,1,1,0,0,0,0,0,0,36047046201,11230
46201,2006,2,1,1,2,2,2,-0.5,-1,-0.5,-1,-0.5,-1,36047046201,11230
46201,2007,0,2,2,1,1,1,1,1,1,1,1,1,36047046201,11230
46201,2007,2,1,0,1,1,1,0,0,0,0,0,0,36047046201,11230
46201,2008,0,1,1,2,2,2,-0.5,-1,-0.5,-1,-0.5,-1,36047046201,11230
46201,2008,1,2,1,1,1,1,1,1,1,1,1,1,36047046201,11230
46201,2008,4,1,0,0,0,0,1,1,1,1,1,1,36047046201,11230
46201,2008,5,1,1,1,1,1,0,0,0,0,0,0,36047046201,11230
46201,2009,1,2,0,2,1,1,0,0,1,1,1,1,36047046201,11230
46201,2009,2,1,2,1,1,1,0,0,0,0,0,0,36047046201,11230
46201,2009,3,1,1,0,0,0,1,1,1,1,1,1,36047046201,11230
46201,2010,0,3,3,2,2,2,0.5,1,0.5,1,0.5,1,36047046201,11230
46201,2010,1,1,3,2,0,0,-0.5,-1,1,1,1,1,36047046201,11230
46201,2010,2,3,1,1,1,1,2,2,2,2,2,2,36047046201,11230
46201,2010,3,1,3,1,0,0,0,0,1,1,1,1,36047046201,11230
46201,2010,4,2,1,0,0,0,1,2,1,2,1,2,36047046201,11230
50804,2001,4,1,0,1,1,1,0,0,0,0,0,0,,
51601,2001,4,1,0,1,1,1,0,0,0,0,0,0,,
51601,2001,5,1,1,1,1,1,0,0,0,0,0,0,,
51601,2002,4,1,0,1,1,1,0,0,0,0,0,0,,
51601,2002,5,1,1,1,1,1,0,0,0,0,0,0,,
51601,2003,0,1,1,0,1,1,1,1,0,0,0,0,,
51601,2003,5,1,0,1,1,1,0,0,0,0,0,0,,
61002,2003,5,1,0,0,1,1,1,1,0,0,0,0,36047061002,11235
69602,2006,4,1,0,0,0,0,1,1,1,1,1,1,,
69602,2007,5,1,0,0,0,0,1,1,1,1,1,1,,
